Big Boi	occupation	"African, Caribbean and Pacific Group of States"
Islam	occupation	Organisation for the Prohibition of Chemical Weapons
Trinidad and Tobago	diplomatic relation	"African, Caribbean and Pacific Group of States"
Master P	instrument	Agency for the Prohibition of Nuclear Weapons in Latin America and the Caribbean
August Ludwig von Schlözer	diplomatic relation	Organization for Security and Co-operation in Europe
G. K. Chesterton	occupation	"African, Caribbean and Pacific Group of States"
Austrian Academy of Sciences	member of	People's Republic of China
Republic of Cyprus	diplomatic relation	"African, Caribbean and Pacific Group of States"
Irène Joliot-Curie	member of	International Bank for Reconstruction and Development
Faith Evans	member of	"African, Caribbean and Pacific Group of States"
Mos Def	occupation	People's Republic of China
Erykah Badu	member of	Organisation for the Prohibition of Chemical Weapons
Jay Chou	languages spoken, written, or signed	Organisation for the Prohibition of Chemical Weapons
Ethiopia	diplomatic relation	"African, Caribbean and Pacific Group of States"
John Ciardi	occupation	"African, Caribbean and Pacific Group of States"
Yehudi Menuhin	country of citizenship	Organization for Security and Co-operation in Europe
J. K. Rowling	country of citizenship	University of Paris (1896-1968)
Somalia	occupation	"African, Caribbean and Pacific Group of States"
Billy Bob Thornton	occupation	"African, Caribbean and Pacific Group of States"
Peter Lorre	member of	Organization for Security and Co-operation in Europe
Tila Tequila	occupation	Organisation for the Prohibition of Chemical Weapons
Michael Cera	occupation	Organisation for the Prohibition of Chemical Weapons
Oswald Heer	instrument	Organization for Security and Co-operation in Europe
Snoop Dogg	occupation	International Centre for Settlement of Investment Disputes
Elizabeth Bishop	instrument	Organisation for the Prohibition of Chemical Weapons
Grenada	part of	"African, Caribbean and Pacific Group of States"
Vladimir Vysotsky	member of	"African, Caribbean and Pacific Group of States"
Hayley Williams	diplomatic relation	Organisation for the Prohibition of Chemical Weapons
Venezuela	occupation	"African, Caribbean and Pacific Group of States"
Mary Shelley	country of citizenship	Organisation for the Prohibition of Chemical Weapons
Kid Cudi	instrument	Organisation for the Prohibition of Chemical Weapons
Bertolt Brecht	member of	Accademia Nazionale delle Scienze detta dei XL
Emilie Autumn	diplomatic relation	Agency for the Prohibition of Nuclear Weapons in Latin America and the Caribbean
John Travolta	diplomatic relation	Organisation for the Prohibition of Chemical Weapons
Jan Josef Liefers	occupation	University of Paris (1896-1968)
Joan Baez	occupation	"African, Caribbean and Pacific Group of States"
Larry David	instrument	International Centre for Settlement of Investment Disputes
Luciano Berio	diplomatic relation	Organization for Security and Co-operation in Europe
Jean-Baptiste Biot	occupation	Organisation for the Prohibition of Chemical Weapons
Jean-Antoine-Nicolas de Caritat de Condorcet	occupation	American Academy of Arts and Letters
Paul Jozef Crutzen	occupation	International Centre for Settlement of Investment Disputes
Jordan	member of	Organisation for the Prohibition of Chemical Weapons
People's Republic of China	member of	Organization for Security and Co-operation in Europe
United Kingdom of Great Britain and Ireland	occupation	Multilateral Investment Guarantee Agency
André-Marie Ampère	instrument	International Centre for Settlement of Investment Disputes
Simon Sechter	residence	Agency for the Prohibition of Nuclear Weapons in Latin America and the Caribbean
Graham Greene	occupation	International Bank for Reconstruction and Development
Nikolai Fomenko	languages spoken, written, or signed	"African, Caribbean and Pacific Group of States"
Pierre Boulez	genre	Organization for Security and Co-operation in Europe
Central African Republic	occupation	Organisation for the Prohibition of Chemical Weapons
Lily Allen	genre	Organisation for the Prohibition of Chemical Weapons
Arthur Conan Doyle	place of burial	Multilateral Investment Guarantee Agency
August Ludwig von Schlözer	occupation	Organisation for the Prohibition of Chemical Weapons
Tuvalu	occupation	University of Paris (1896-1968)
Kyle Gass	member of	Organisation for the Prohibition of Chemical Weapons
Henri Poincaré	occupation	International Bank for Reconstruction and Development
Marshall Islands	occupation	International Centre for Settlement of Investment Disputes
Missy Elliott	occupation	International Bank for Reconstruction and Development
John Hartford	occupation	People's Republic of China
Charlotte Gainsbourg	member of	International Bank for Reconstruction and Development
Ava Gardner	diplomatic relation	Multilateral Investment Guarantee Agency
Trent Reznor	member of	Organisation for the Prohibition of Chemical Weapons
Guyana	occupation	International Centre for Settlement of Investment Disputes
People's Republic of China	field of work	Cuba
Lithuania	occupation	Organisation for the Prohibition of Chemical Weapons
H. P. Lovecraft	occupation	American Academy of Arts and Letters
Mauritius	diplomatic relation	Organisation for the Prohibition of Chemical Weapons
Gabon	diplomatic relation	International Centre for Settlement of Investment Disputes
People's Republic of China	influenced by	William Morris
Paul Krugman	record label	International Centre for Settlement of Investment Disputes
Cuba	occupation	Organisation for the Prohibition of Chemical Weapons
Andy Griffith	member of	Organization for Security and Co-operation in Europe
John William Strutt, 3rd Baron Rayleigh	occupation	Serbian Academy of Sciences and Arts
Jerry Lee Lewis	instrument	International Centre for Settlement of Investment Disputes
Amanda Palmer	occupation	Organisation for the Prohibition of Chemical Weapons
El Salvador	field of work	University of Paris (1896-1968)
Yehudi Menuhin	field of work	International Centre for Settlement of Investment Disputes
Otto Schmidt	member of	People's Republic of China
Montesquieu	occupation	People's Republic of China
Buckminster Fuller	languages spoken, written, or signed	"African, Caribbean and Pacific Group of States"
Benjamin Franklin	diplomatic relation	People's Republic of China
Rebbie Jackson	occupation	International Centre for Settlement of Investment Disputes
Singapore	diplomatic relation	Organisation for the Prohibition of Chemical Weapons
Emma Bunton	ethnic group	University of Paris (1896-1968)
Robert Downey, Jr.	languages spoken, written, or signed	Multilateral Investment Guarantee Agency
Jay Chou	occupation	International Bank for Reconstruction and Development
Camillo Golgi	record label	International Centre for Settlement of Investment Disputes
Lars Onsager	genre	International Bank for Reconstruction and Development
Tionne Watkins	diplomatic relation	International Bank for Reconstruction and Development
Mikhail Vassilyevich Lomonosov	occupation	International Centre for Settlement of Investment Disputes
Bob Hope	genre	International Centre for Settlement of Investment Disputes
Jason Derulo	occupation	International Centre for Settlement of Investment Disputes
Yegor Letov	headquarters location	Organisation for the Prohibition of Chemical Weapons
Gore Vidal	occupation	International Bank for Reconstruction and Development
Celeste Buckingham	occupation	International Bank for Reconstruction and Development
Kiribati	occupation	Multilateral Investment Guarantee Agency
Master P	occupation	International Centre for Settlement of Investment Disputes
United States of America	member of	Organization for Security and Co-operation in Europe
Leon Battista Alberti	instrument	People's Republic of China
R. Kelly	influenced by	African Union – United Nations Hybrid Operation in Darfur
Brian May	occupation	Organization for Security and Co-operation in Europe
Donny Osmond	member of	American Academy of Arts and Sciences
Ray Bradbury	diplomatic relation	Organisation for the Prohibition of Chemical Weapons
Ivan Andreyevich Krylov	diplomatic relation	International Centre for Settlement of Investment Disputes
State of Palestine	member of	International Bank for Reconstruction and Development
People's Republic of China	diplomatic relation	Peru
Avery Brooks	country of citizenship	International Bank for Reconstruction and Development
Ralf Dahrendorf	occupation	People's Republic of China
Philip Glass	genre	University of Paris (1896-1968)
Pierre Boulez	member of	International Telecommunication Union
John Muir	occupation	International Centre for Settlement of Investment Disputes
North Macedonia	occupation	People's Republic of China
John William Strutt, 3rd Baron Rayleigh	instrument	Kingdom of Prussia
North Korea	record label	"African, Caribbean and Pacific Group of States"
Claudio Magris	occupation	Accademia Nazionale delle Scienze detta dei XL
Jimmy Fallon	member of	African Union – United Nations Hybrid Operation in Darfur
Ulrich von Wilamowitz-Moellendorff	member of	George Eliot
Guy de Maupassant	occupation	Multilateral Investment Guarantee Agency
Etta James	diplomatic relation	International Centre for Settlement of Investment Disputes
Ray Davies	record label	Accademia Nazionale delle Scienze detta dei XL
Saint Vincent and the Grenadines	country of citizenship	Multilateral Investment Guarantee Agency
Václav Havel	occupation	International Bank for Reconstruction and Development
50 Cent	member of	International Centre for Settlement of Investment Disputes
Janet Jackson	member of	International Centre for Settlement of Investment Disputes
Christina Milian	influenced by	Organisation for the Prohibition of Chemical Weapons
Paul Simon	occupation	International Bank for Reconstruction and Development
Nick Cave	diplomatic relation	Organisation for the Prohibition of Chemical Weapons
LeToya Luckett	occupation	International Bank for Reconstruction and Development
Richard Harris	member of	People's Republic of China
T. S. Eliot	occupation	International Centre for Settlement of Investment Disputes
People's Republic of China	languages spoken, written, or signed	Federated States of Micronesia
Big Boi	country of citizenship	People's Republic of China
Finland	diplomatic relation	Organisation for the Prohibition of Chemical Weapons
South Africa	diplomatic relation	Organisation for the Prohibition of Chemical Weapons
Stephen Jay Gould	country of citizenship	International Bank for Reconstruction and Development
Joseph Fourier	occupation	International Bank for Reconstruction and Development
Peter Lorre	occupation	African Union – United Nations Hybrid Operation in Darfur
Cameroon	occupation	People's Republic of China
Tracy Chapman	languages spoken, written, or signed	International Centre for Settlement of Investment Disputes
Neil Patrick Harris	educated at	International Centre for Settlement of Investment Disputes
South Sudan	occupation	International Bank for Reconstruction and Development
Anatoly Krupnov	occupation	Accademia Nazionale delle Scienze detta dei XL
AJ Michalka	member of	International Bank for Reconstruction and Development
Sakis Rouvas	diplomatic relation	American Academy of Arts and Sciences
Amos Oz	educated at	People's Republic of China
Lord Byron	residence	American Academy of Arts and Sciences
North Macedonia	genre	International Centre for Settlement of Investment Disputes
Tim Rice-Oxley	member of	Organisation internationale de la Francophonie
Leó Szilárd	diplomatic relation	International Centre for Settlement of Investment Disputes
Anton Chekhov	member of	American Academy of Arts and Sciences
Palau	diplomatic relation	People's Republic of China
Samuel Johnson	occupation	American Academy of Arts and Letters
John William Strutt, 3rd Baron Rayleigh	member of	Prague
G. K. Chesterton	member of	American Academy of Arts and Letters
Ľudovít Štúr	influenced by	Organisation for the Prohibition of Chemical Weapons
Ava Gardner	part of	Multilateral Investment Guarantee Agency
Philip Warren Anderson	occupation	Organization for Security and Co-operation in Europe
South Korea	diplomatic relation	People's Republic of China
Paris	member of	International Finance Corporation
Jamie Foxx	country	Organisation for the Prohibition of Chemical Weapons
Alexander R. Todd, Baron Todd	languages spoken, written, or signed	International Bank for Reconstruction and Development
Andorra	religion	Multilateral Investment Guarantee Agency
J. R. R. Tolkien	occupation	International Bank for Reconstruction and Development
New Zealand	ethnic group	International Centre for Settlement of Investment Disputes
Masiela Lusha	diplomatic relation	Organisation for the Prohibition of Chemical Weapons
Yevgeny Zamyatin	place of death	People's Republic of China
Dolly Parton	languages spoken, written, or signed	Agency for the Prohibition of Nuclear Weapons in Latin America and the Caribbean
Joe Jackson	occupation	International Telecommunication Union
Ernst Mach	languages spoken, written, or signed	International Bank for Reconstruction and Development
People's Republic of China	instrument	John Milton
People's Republic of China	official language	International Telecommunication Union
Rickie Lee Jones	diplomatic relation	International Centre for Settlement of Investment Disputes
Aram Khachaturian	member of	Multilateral Investment Guarantee Agency
Jack Black	member of	International Bank for Reconstruction and Development
People's Republic of China	diplomatic relation	Commonwealth of Nations
Dino Buzzati	occupation	American Academy of Arts and Sciences
Colm Tóibín	diplomatic relation	International Bank for Reconstruction and Development
Beth Hart	occupation	American Academy of Arts and Sciences
Salvador de Madariaga	occupation	International Centre for Settlement of Investment Disputes
Yoshiki	influenced by	International Bank for Reconstruction and Development
Ray Lankester	genre	Multilateral Investment Guarantee Agency
George Ellery Hale	diplomatic relation	Multilateral Investment Guarantee Agency
Linda Ronstadt	occupation	Accademia Nazionale delle Scienze detta dei XL
Australia	diplomatic relation	"African, Caribbean and Pacific Group of States"
Ringo Starr	occupation	American Academy of Arts and Sciences
Anthony Kiedis	diplomatic relation	American Academy of Arts and Sciences
Ernst Curtius	occupation	Organization for Security and Co-operation in Europe
Yemen	instrument	Multilateral Investment Guarantee Agency
Nena	occupation	University of Paris (1896-1968)
Dennis Hopper	instrument	African Union – United Nations Hybrid Operation in Darfur
Paul Jozef Crutzen	record label	International Bank for Reconstruction and Development
Donald Trump	diplomatic relation	People's Republic of China
People's Republic of China	genre	Rebbie Jackson
Igor Stravinsky	educated at	International Bank for Reconstruction and Development
Yemen	diplomatic relation	International Bank for Reconstruction and Development
Luxembourg	occupation	Organisation for the Prohibition of Chemical Weapons
Ulrich von Wilamowitz-Moellendorff	member of	German Academy of Sciences Leopoldina
Zoolander	genre	Bavarian Academy of Sciences and Humanities
Lucio Dalla	occupation	African Union – United Nations Hybrid Operation in Darfur
Noam Chomsky	occupation	International Centre for Settlement of Investment Disputes
Russell Brand	diplomatic relation	International Bank for Reconstruction and Development
Saint Vincent and the Grenadines	employer	International Telecommunication Union
"Weird Al" Yankovic	diplomatic relation	Bavarian Academy of Sciences and Humanities
John William Strutt, 3rd Baron Rayleigh	employer	American Academy of Arts and Sciences
Kenya	occupation	International Bank for Reconstruction and Development
People's Republic of China	instrument	Académie Française
People's Republic of China	employer	Ivory Coast
Lou Reed	diplomatic relation	International Bank for Reconstruction and Development
T. S. Eliot	country of citizenship	International Centre for Settlement of Investment Disputes
Frédéric Chopin	member of	Organisation for the Prohibition of Chemical Weapons
Brazil	instrument	Organisation for the Prohibition of Chemical Weapons
Stanislao Cannizzaro	genre	International Centre for Settlement of Investment Disputes
Nat King Cole	occupation	African Union – United Nations Hybrid Operation in Darfur
Debby Ryan	genre	American Academy of Arts and Letters
Sir George Stokes, 1st Baronet	part of	H. P. Lovecraft
Pakistan	place of death	Organisation for the Prohibition of Chemical Weapons
Martin Buber	diplomatic relation	Multilateral Investment Guarantee Agency
Wilhelm Ostwald	religion	Multilateral Investment Guarantee Agency
Robin Gibb	record label	American Academy of Arts and Sciences
Milva	member of	American Academy of Arts and Sciences
Jô Soares	occupation	American Academy of Arts and Sciences
People's Republic of China	employer	Kingdom of Prussia
Czech Republic	record label	International Bank for Reconstruction and Development
Ivan Franko	record label	African Union – United Nations Hybrid Operation in Darfur
Louis Armstrong	instrument	International Centre for Settlement of Investment Disputes
Republic of Cyprus	occupation	International Bank for Reconstruction and Development
Ayọ	diplomatic relation	Multilateral Investment Guarantee Agency
Jared Leto	part of	International Centre for Settlement of Investment Disputes
Henri Poincaré	occupation	Organization for Security and Co-operation in Europe
Friedrich Schiller	member of	People's Republic of China
Michail Sholokhov	member of	Société Philomathique de Paris
Nikita Mikhalkov	diplomatic relation	People's Republic of China
People's Republic of China	diplomatic relation	University of Cambridge
J. Robert Oppenheimer	diplomatic relation	African Union – United Nations Hybrid Operation in Darfur
Dmitri Kabalevsky	diplomatic relation	International Bank for Reconstruction and Development
Sri Lanka	genre	Multilateral Investment Guarantee Agency
Wolfgang Amadeus Mozart	occupation	Royal Prussian Academy of Sciences
Donald Knuth	influenced by	Société Philomathique de Paris
Korney Chukovsky	occupation	American Academy of Arts and Sciences
Crispin Glover	instrument	Organisation for the Prohibition of Chemical Weapons
John Mayer	genre	English
Connie Smith	languages spoken, written, or signed	International Centre for Settlement of Investment Disputes
Jay Chou	occupation	Multilateral Investment Guarantee Agency
Saint Vincent and the Grenadines	occupation	Parlophone
East Timor	member of political party	International Telecommunication Union
Taylor Swift	occupation	American Academy of Arts and Sciences
Guy de Maupassant	employer	Royal Prussian Academy of Sciences
Jack Black	diplomatic relation	People's Republic of China
Elizabeth Bishop	spouse	International Telecommunication Union
W.E.B. Du Bois	languages spoken, written, or signed	Multilateral Investment Guarantee Agency
People's Republic of China	instrument	Argentina
Bolivia	country of citizenship	Organization for Security and Co-operation in Europe
Russell Brand	field of work	Royal Prussian Academy of Sciences
Athanasius Kircher	languages spoken, written, or signed	Latin
State of Palestine	member of	Organisation of Islamic Cooperation
Federated States of Micronesia	country of citizenship	World Trade Organization
J. M. Coetzee	member of	National Academy of Sciences
Munich	diplomatic relation	Multilateral Investment Guarantee Agency
Anatoly Krupnov	residence	Multilateral Investment Guarantee Agency
Hans Mayer	country of citizenship	International Centre for Settlement of Investment Disputes
Saint Vincent and the Grenadines	diplomatic relation	Montenegro
Jean-Luc Godard	member of	American Academy of Arts and Sciences
Glukoza	country of citizenship	International Centre for Settlement of Investment Disputes
Lisa Loeb	genre	Bavarian Academy of Sciences and Humanities
Kevin Jonas	member of	American Academy of Arts and Sciences
Robert Penn Warren	occupation	International Telecommunication Union
Busta Rhymes	genre	American Academy of Arts and Sciences
Lionel Richie	occupation	American Academy of Arts and Letters
United States of America	occupation	Britney Spears
People's Republic of China	diplomatic relation	India
Mihajlo Pupin	place of death	American Academy of Arts and Letters
Jean Gaston Darboux	religion	International Bank for Reconstruction and Development
Wernher von Braun	occupation	International Telecommunication Union
Dominica	member of	International Telecommunication Union
Ludacris	member of	Group on Earth Observations
Nat King Cole	diplomatic relation	Organisation for the Prohibition of Chemical Weapons
Uruguay	country of citizenship	Organisation for the Prohibition of Chemical Weapons
Connie Smith	occupation	American Academy of Arts and Sciences
Umberto Eco	named after	International Bank for Reconstruction and Development
Celeste Buckingham	occupation	American Academy of Arts and Sciences
Mozambique	occupation	Accademia Nazionale delle Scienze detta dei XL
Joseph E. Stiglitz	member of	American Academy of Arts and Sciences
United States of America	diplomatic relation	Organization of American States
Bobby Darin	member of	American Academy of Arts and Sciences
Carl Sagan	religion	International Bank for Reconstruction and Development
Isaac Bashevis Singer	occupation	Organisation for Economic Cooperation and Development
Greece	diplomatic relation	Organisation for the Prohibition of Chemical Weapons
Ross Bagdasarian Sr.	genre	International Telecommunication Union
Sheldon Lee Glashow	instrument	People's Republic of China
People's Republic of China	diplomatic relation	Poland
Zemfira	genre	International Bank for Reconstruction and Development
Aimee Mann	diplomatic relation	American Academy of Arts and Sciences
Allan Sherman	diplomatic relation	International Centre for Settlement of Investment Disputes
Peter Kropotkin	genre	American Academy of Arts and Letters
Paula Abdul	genre	University of Paris (1896-1968)
Lou Reed	member of	People's Republic of China
Aleksandr Solzhenitsyn	occupation	Multilateral Investment Guarantee Agency
Benoit Mandelbrot	record label	Organisation internationale de la Francophonie
Rodion Shchedrin	genre	American Academy of Arts and Sciences
Joseph Brodsky	occupation	American Academy of Arts and Letters
Bangladesh	diplomatic relation	Organization for Security and Co-operation in Europe
Azerbaijan	diplomatic relation	Agency for the Prohibition of Nuclear Weapons in Latin America and the Caribbean
Rita Levi-Montalcini	languages spoken, written, or signed	Latin
Academy of Useful Science	educated at	Universal Postal Union
John Ruskin	country of citizenship	Organisation internationale de la Francophonie
Stephen King	member of	Alliance of Small Island States
Seychelles	occupation	African Union – United Nations Hybrid Operation in Darfur
Paul Jozef Crutzen	instrument	People's Republic of China
Algeria	ethnic group	"African, Caribbean and Pacific Group of States"
Armenia	occupation	English
Henry Louis Le Châtelier	country of citizenship	Royal Prussian Academy of Sciences
Antoine César Becquerel	country of citizenship	English
Paul Dirac	influenced by	International Telecommunication Union
Jonathan Winters	member of	Royal Prussian Academy of Sciences
Andrei Tarkovsky	place of death	United Kingdom of Great Britain and Ireland
Syd Barrett	occupation	International Centre for Settlement of Investment Disputes
Mario Praz	instrument	International Bank for Reconstruction and Development
Ulrich von Wilamowitz-Moellendorff	diplomatic relation	Multilateral Investment Guarantee Agency
Taylor Momsen	diplomatic relation	Organisation for Economic Cooperation and Development
People's Republic of China	field of work	Turkey
William Thomson, 1st Baron Kelvin	member of	Portuguese Empire
Claude Lévi-Strauss	record label	People's Republic of China
Mark Wahlberg	diplomatic relation	American Academy of Arts and Sciences
Oprah Winfrey	instrument	International Telecommunication Union
Bhutan	country of citizenship	American Academy of Arts and Sciences
Kevin Costner	occupation	Organisation internationale de la Francophonie
Henry David Thoreau	occupation	International Development Association
People's Republic of China	member of	English people
Alexander von Humboldt	occupation	People's Republic of China
Enrique Iglesias	occupation	American Academy of Arts and Sciences
Melchior de Vogüé	occupation	Multilateral Investment Guarantee Agency
Rita Levi-Montalcini	occupation	Multilateral Investment Guarantee Agency
Joan Jett	record label	United Kingdom of Great Britain and Ireland
Alice Walker	religion	American Academy of Arts and Sciences
Kazakhstan	diplomatic relation	University of Paris (1896-1968)
Jay-Z	occupation	American Academy of Arts and Sciences
Per Olov Enquist	diplomatic relation	English
John William Strutt, 3rd Baron Rayleigh	genre	Group on Earth Observations
Camille Saint-Saëns	occupation	International Telecommunication Union
Alan Stivell	instrument	United Kingdom of Great Britain and Ireland
T. S. Eliot	diplomatic relation	American Academy of Arts and Sciences
John William Strutt, 3rd Baron Rayleigh	occupation	Albania
Julia Volkova	member of	Multilateral Investment Guarantee Agency
Jon Bon Jovi	religion	International Finance Corporation
Malta	diplomatic relation	Agency for the Prohibition of Nuclear Weapons in Latin America and the Caribbean
Rickie Lee Jones	genre	American Academy of Arts and Sciences
People's Republic of China	occupation	Academy of Sciences of Turin
Richard Marx	diplomatic relation	English
George Porter, Baron Porter of Luddenham	diplomatic relation	Académie Française
Qatar	languages spoken, written, or signed	English
Margaret Atwood	occupation	Accademia Nazionale delle Scienze detta dei XL
Wilhelm Grimm	instrument	English
Giovanni Schiaparelli	member of	Royal Swedish Academy of Sciences
Saint Kitts and Nevis	diplomatic relation	American Academy of Arts and Sciences
Neil Patrick Harris	occupation	International Telecommunication Union
Federated States of Micronesia	unmarried partner	Commonwealth of Nations
Wilhelm von Humboldt	place of birth	Multilateral Investment Guarantee Agency
Bob Seger	occupation	Group on Earth Observations
Dannii Minogue	place of birth	American Academy of Arts and Sciences
Dominican Republic	occupation	International Development Association
Harry Chapin	languages spoken, written, or signed	International Bank for Reconstruction and Development
Paul Anka	employer	English
John Lydon	member of	United Kingdom of Great Britain and Ireland
Ursula K. Le Guin	genre	English
Henri Victor Regnault	occupation	American Academy of Arts and Sciences
Uzeyir Hajibeyov	place of birth	Royal Prussian Academy of Sciences
Gustavo Cerati	occupation	Organisation internationale de la Francophonie
Miranda Cosgrove	occupation	American Academy of Arts and Letters
Adriano Celentano	diplomatic relation	International Telecommunication Union
Venezuela	member of	People's Republic of China
David Byrne	instrument	International Telecommunication Union
Beth Hart	diplomatic relation	International Finance Corporation
Siméon Denis Poisson	occupation	English
United States of America	occupation	Sudan
Edgar Allan Poe	diplomatic relation	International Telecommunication Union
Grenada	educated at	American Academy of Arts and Sciences
Deryck Whibley	member of	American Academy of Arts and Sciences
Boris Grebenshchikov	religion	American Academy of Arts and Sciences
Nora Ephron	member of	English
Anton Bruckner	continent	American Academy of Arts and Letters
Bret Easton Ellis	continent	International Telecommunication Union
Lana Del Rey	influenced by	English
Czech Republic	country of citizenship	African Union – United Nations Hybrid Operation in Darfur
Ashanti	country	Multilateral Investment Guarantee Agency
Bridgit Mendler	occupation	Accademia Nazionale delle Scienze detta dei XL
Taraneh Javanbakht	diplomatic relation	Royal Swedish Academy of Sciences
Alsou	residence	Accademia Nazionale delle Scienze detta dei XL
Amy Lee	languages spoken, written, or signed	African Union – United Nations Hybrid Operation in Darfur
Lil' Kim	influenced by	American Academy of Arts and Sciences
Sandy	record label	People's Republic of China
Carl Peter Thunberg	diplomatic relation	International Bank for Reconstruction and Development
Blaise Pascal	diplomatic relation	United Kingdom of Great Britain and Ireland
Azerbaijan	diplomatic relation	Accademia Nazionale delle Scienze detta dei XL
Andrew Ridgeley	occupation	Arab Bank for Economic Development in Africa
Slovakia	diplomatic relation	International Telecommunication Union
United States of America	occupation	International Bank for Reconstruction and Development
Netherlands	occupation	English
Hans Christian Ørsted	occupation	German
Kanye West	member of	Group on Earth Observations
James Franco	member of	Organisation for Economic Cooperation and Development
Carl Friedrich von Weizsäcker	religion	German Academy of Sciences Leopoldina
Jorge Amado	occupation	American Academy of Arts and Sciences
Satyajit Ray	member of	Royal Swedish Academy of Sciences
Joseph Heller	occupation	German
Reprise Records	occupation	Universal Postal Union
Ed Sheeran	employer	American Academy of Arts and Sciences
Common	diplomatic relation	International Bank for Reconstruction and Development
Charles Babbage	languages spoken, written, or signed	International Bank for Reconstruction and Development
Mick Ronson	cause of death	Royal Netherlands Academy of Arts and Sciences
Pakistan	languages spoken, written, or signed	Organisation for the Prohibition of Chemical Weapons
Guinea-Bissau	member of	Universal Postal Union
Lonnie Liston Smith	diplomatic relation	English
Turkmenistan	diplomatic relation	American Academy of Arts and Letters
Mark Oliver Everett	occupation	Russian
George Harrison	diplomatic relation	International Bank for Reconstruction and Development
Oswald Heer	member of	American Academy of Arts and Sciences
Kingdom of Prussia	member of	World Trade Organization
Armenia	country of citizenship	International Bank for Reconstruction and Development
Paul Jozef Crutzen	languages spoken, written, or signed	English
Kenny Rogers	occupation	People's Republic of China
Katerina Graham	occupation	English
Yo-Yo Ma	occupation	Royal Swedish Academy of Sciences
Gackt	occupation	German Academy of Sciences Leopoldina
Armenia	diplomatic relation	American Academy of Arts and Sciences
Shel Silverstein	member of	World Trade Organization
Vladislav Krapivin	occupation	English
Jim Messina	diplomatic relation	International Telecommunication Union
Asia Argento	residence	American Academy of Arts and Sciences
A. R. Rahman	member of	Asia-Pacific Economic Cooperation
Harold Bloom	genre	English
Holly Near	diplomatic relation	English
Bosnia and Herzegovina	residence	Universal Postal Union
Philippines	country of citizenship	Organisation for the Prohibition of Chemical Weapons
Yegor Letov	member of political party	Royal Swedish Academy of Sciences
Wolfhart Pannenberg	occupation	World Trade Organization
Tajikistan	diplomatic relation	Alliance of Small Island States
Slovakia	diplomatic relation	Multilateral Investment Guarantee Agency
Katharine McPhee	instrument	International Finance Corporation
Graham Greene	country of citizenship	United States of America
Jeff Bridges	headquarters location	English
Louis Armstrong	member of	Royal Prussian Academy of Sciences
Jean Le Rond d'Alembert	member of	Russian
Winston Churchill	member of	Academy of Sciences of Turin
Martin Sheen	ethnic group	English
Federated States of Micronesia	occupation	World Trade Organization
M.I.A.	occupation	English
Tatyana Tolstaya	occupation	Arab Fund for Economic and Social Development
Steve Martin	record label	Bavarian Academy of Sciences and Humanities
Anton Bruckner	diplomatic relation	American Academy of Arts and Sciences
Somalia	influenced by	American Academy of Arts and Sciences
Virginia Woolf	religion	International Telecommunication Union
Syria	place of burial	Organisation for the Prohibition of Chemical Weapons
Albrecht von Haller	member of	German
Theodore von Kármán	member of	Italian
John Stuart Mill	diplomatic relation	English
Ursula K. Le Guin	genre	Multilateral Investment Guarantee Agency
Aaron Copland	genre	People's Republic of China
Tyler, the Creator	diplomatic relation	International Telecommunication Union
Myanmar	country of citizenship	American Academy of Arts and Sciences
Holly Near	country	English
Cameroon	occupation	International Telecommunication Union
Jan Evangelista Purkyně	occupation	Academy of Arts, Berlin
Susan Sontag	continent	English
Czech Republic	member of	American Academy of Arts and Letters
George Martin	instrument	Latin
Tomáš Garrigue Masaryk	member of	Immanuel Kant
United States of America	religion	Peter Kropotkin
Andriy Danylko	member of	English
Santiago Ramón y Cajal	diplomatic relation	Missile Technology Control Regime
Ed Harris	diplomatic relation	United Kingdom of Great Britain and Ireland
Turkmenistan	occupation	African Union – United Nations Hybrid Operation in Darfur
"Weird Al" Yankovic	occupation	American Academy of Arts and Sciences
Ernst Mach	diplomatic relation	Bavarian Academy of Sciences and Humanities
James Lighthill	occupation	People's Republic of China
Costa Rica	country of citizenship	Organisation for Economic Cooperation and Development
John Locke	member of	Royal Swedish Academy of Sciences
E. T. A. Hoffmann	diplomatic relation	Russian
Massimo Bontempelli	diplomatic relation	Academy of Sciences of Turin
Zooey Deschanel	languages spoken, written, or signed	English
Sri Lanka	occupation	American Academy of Arts and Sciences
Serbia	genre	International Bank for Reconstruction and Development
David Mitchell	genre	English
Aram Khachaturian	employer	English
David Hume	occupation	International Finance Corporation
Eswatini	occupation	Organization of American States
Sandy	occupation	International Telecommunication Union
M. Pokora	genre	English
Tupac Shakur	record label	English
Ulrich von Wilamowitz-Moellendorff	diplomatic relation	Netherlands
Mexico	place of birth	People's Republic of China
John Bardeen	country of citizenship	English
Danny Glover	country of citizenship	International Hydrographic Organization
People's Republic of China	occupation	India
Benin	genre	World Trade Organization
Stephen Jay Gould	field of work	American Academy of Arts and Letters
Gavriil Troyepolsky	genre	American Academy of Arts and Sciences
Vladimir Turchinsky	member of	English
Sri Lanka	employer	Multilateral Investment Guarantee Agency
Rwanda	place of death	International Telecommunication Union
Janis Joplin	occupation	English
Tamer Hosny	diplomatic relation	International Hydrographic Organization
Honoré de Balzac	diplomatic relation	Organization of American States
Paul Simon	diplomatic relation	English
Lauryn Hill	country of citizenship	Academy of Sciences of Turin
Luxembourg	country of citizenship	Accademia Nazionale delle Scienze detta dei XL
Tito Jackson	languages spoken, written, or signed	Russian
People's Republic of China	employer	businessperson
T. S. Eliot	occupation	Georg Wilhelm Friedrich Hegel
Urbain Le Verrier	diplomatic relation	Hungarian Academy of Sciences
Serge Gainsbourg	occupation	English
Ray Davies	diplomatic relation	International Telecommunication Union
Wilhelm Ostwald	occupation	English
Tristan Tzara	member of	English
Busta Rhymes	country of citizenship	English
Paul McCartney	instrument	African Union – United Nations Hybrid Operation in Darfur
Dominica	occupation	International Development Association
George Carlin	member of	American Academy of Arts and Sciences
Burundi	diplomatic relation	International Telecommunication Union
Spike Milligan	occupation	Organisation internationale de la Francophonie
John Hartford	place of birth	Société Philomathique de Paris
Gilbert Bécaud	languages spoken, written, or signed	Bavarian Academy of Sciences and Humanities
Galileo Galilei	country of citizenship	Royal Netherlands Academy of Arts and Sciences
Greece	member of	International Telecommunication Union
Seamus Heaney	country of citizenship	American Academy of Arts and Sciences
Jaroslav Vrchlický	occupation	Multilateral Investment Guarantee Agency
United States of America	diplomatic relation	Australia
Netherlands	member of	English
James Blake	occupation	Academy of Sciences of Turin
Nick Jonas	occupation	International Telecommunication Union
Singapore	official language	American Academy of Arts and Letters
Montesquieu	influenced by	International Finance Corporation
Dorothy L. Sayers	occupation	Group on Earth Observations
Robin Thicke	genre	English
Sir George Stokes, 1st Baronet	genre	Latin America
Yevgeny Yevtushenko	occupation	Russian
Russia	diplomatic relation	Organisation for the Prohibition of Chemical Weapons
Bangladesh	occupation	International Bank for Reconstruction and Development
United States of America	member of	Tunisia
People's Republic of China	religion	Humboldt University of Berlin
Iceland	location of formation	International Telecommunication Union
Gabriel Marcel	member of	French
James Franco	occupation	Bavarian Academy of Sciences and Humanities
Alan Arkin	member of	English
Bahamas	occupation	Royal Netherlands Academy of Arts and Sciences
Kris Kristofferson	occupation	German
Heinrich Wilhelm Gottfried von Waldeyer-Hartz	diplomatic relation	Carly Simon
Euclides da Cunha	genre	English
Russia	member of political party	International Centre for Settlement of Investment Disputes
Anthony Kiedis	instrument	International Telecommunication Union
Luxembourg	occupation	African Union – United Nations Hybrid Operation in Darfur
Bosnia and Herzegovina	instrument	Nuclear Suppliers Group
Yuri Shevchuk	languages spoken, written, or signed	English
Yevgeny Yevtushenko	member of	Saint Petersburg Academy of Sciences
Gene Autry	occupation	English
Wilhelm von Humboldt	languages spoken, written, or signed	People's Republic of China
Larry David	ethnic group	United States of America
Common	field of work	International Telecommunication Union
Gore Vidal	languages spoken, written, or signed	English
Lauryn Hill	child	French
Mircea Eliade	member of	German
Nicolae Iorga	languages spoken, written, or signed	Communist Party of the Soviet Union
Søren Kierkegaard	member of	Russian
Richard Wagner	member of	People's Republic of China
Gustav Kirchhoff	genre	Multilateral Investment Guarantee Agency
Hayley Kiyoko	diplomatic relation	German Academy of Sciences Leopoldina
Lord Byron	genre	English
Monaco	occupation	International Finance Corporation
Madagascar	employer	American Academy of Arts and Sciences
Debbie Harry	languages spoken, written, or signed	International Telecommunication Union
Frédéric Chopin	occupation	French Academy of Sciences
People's Republic of China	occupation	Greece
Macy Gray	occupation	Alliance of Small Island States
Sheryl Crow	field of work	Royal Netherlands Academy of Arts and Sciences
Darius Milhaud	occupation	English
Anna Akhmatova	occupation	English
Ernest Renan	member of	Royal Netherlands Academy of Arts and Sciences
Slovenia	occupation	Multilateral Investment Guarantee Agency
Democratic Republic of the Congo	spouse	American Academy of Arts and Sciences
Finland	diplomatic relation	Group on Earth Observations
Czech Republic	diplomatic relation	Accademia Nazionale delle Scienze detta dei XL
John de Lancie	member of	German
United States of America	genre	Mozambique
John Cale	official language	American Academy of Arts and Sciences
Franz Miklosich	occupation	English
People's Republic of China	member of	Denmark
United Kingdom	diplomatic relation	Organisation internationale de la Francophonie
Will Smith	diplomatic relation	English
Sheldon Lee Glashow	member of	Russian Academy of Sciences
Eritrea	occupation	International Finance Corporation
Heinrich Schliemann	member of	Academy of Sciences of the USSR
Marcel Proust	diplomatic relation	Royal Swedish Academy of Sciences
Nicaragua	languages spoken, written, or signed	International Telecommunication Union
György Ligeti	religion	English
Adam Sandler	educated at	American Academy of Arts and Sciences
Nicki Minaj	instrument	English
Peter Ustinov	occupation	Organisation internationale de la Francophonie
Béla Bartók	place of burial	International Finance Corporation
W.E.B. Du Bois	diplomatic relation	Asian Development Bank
Miguel de Cervantes	country	German Academy of Sciences Leopoldina
Georges-Louis Leclerc, Comte de Buffon	record label	dance-pop
Siméon Denis Poisson	instrument	"University of California, Los Angeles"
Tyrese Gibson	genre	American Academy of Arts and Sciences
Bill Monroe	member of	African Development Bank
Alicia Keys	instrument	United States of America
Janis Ian	diplomatic relation	Russian
A. A. Milne	country of citizenship	English
Burton Cummings	member of	International Telecommunication Union
Republic of the Congo	diplomatic relation	South Sudan
Jay Chou	member of	French
Philip Roth	religion	American Academy of Arts and Sciences
Mariah Carey	diplomatic relation	American Academy of Arts and Sciences
Jolin Tsai	occupation	American Academy of Arts and Letters
Carlo Rubbia	diplomatic relation	English
CeeLo Green	diplomatic relation	Royal Prussian Academy of Sciences
Stephen Hawking	record label	United States of America
Frédéric Joliot-Curie	place of burial	École Polytechnique
Mary Pickford	place of burial	Arab Bank for Economic Development in Africa
Joseph Liouville	instrument	English
Lord Byron	diplomatic relation	American Academy of Arts and Letters
Republic of the Congo	head of state	African Union
Sidney Sheldon	diplomatic relation	Academy of Sciences of Turin
Kiribati	cause of death	English
Charles Mingus Jr.	occupation	International Hydrographic Organization
Bhutan	ethnic group	International Finance Corporation
Stephen Spender	country of citizenship	French Academy of Sciences
Ludwig Prandtl	record label	Russian
George Porter, Baron Porter of Luddenham	official language	traditional pop music
Norman Mailer	member of	French
Bolivia	diplomatic relation	World Trade Organization
Algeria	occupation	English
Raymond Aron	diplomatic relation	United States of America
A&M Records	residence	World Trade Organization
Janet Jackson	member of	Bavarian Academy of Sciences and Humanities
J. Robert Oppenheimer	languages spoken, written, or signed	Russian
Thomas Mann	record label	English
Mýa	occupation	English
Sweden	employer	People's Republic of China
United States of America	member of	scientist
United States of America	record label	Grenada
Aleksandr Solzhenitsyn	religion	E. T. A. Hoffmann
Yuri Shevchuk	occupation	English
Tupac Shakur	field of work	United States of America
People's Republic of China	occupation	Russian
Condoleezza Rice	country of citizenship	English
Jean Gaston Darboux	country of citizenship	American Academy of Arts and Sciences
Fredro Starr	member of	English
Pedro II of Brazil	diplomatic relation	Russian
Lisa Loeb	country of citizenship	French
Veniamin Smekhov	place of birth	AFRISTAT
Dominica	occupation	Bosnia and Herzegovina
James Cameron	sibling	Saint Petersburg Academy of Sciences
Canada	diplomatic relation	International Telecommunication Union
Slovenia	instrument	Accademia Nazionale delle Scienze detta dei XL
Spain	official language	English
State of Palestine	member of	English
Jérôme Lalande	occupation	Academy of Sciences of the USSR
Pakistan	instrument	International Centre for Settlement of Investment Disputes
Zbigniew Herbert	instrument	German
Montesquieu	occupation	English
Zimbabwe	occupation	English
Hans Christian Ørsted	occupation	Novodevichy Cemetery
Marcellin Berthelot	occupation	Søren Kierkegaard
Klaus Mann	member of	English
Bob Seger	place of death	German
Belarus	occupation	International Telecommunication Union
Léon Theremin	diplomatic relation	German
Myles Kennedy	occupation	English
France	member of political party	Multilateral Investment Guarantee Agency
Kosovo	occupation	Royal Swedish Academy of Sciences
Cass Elliot	country of citizenship	French
Art Garfunkel	occupation	Italian
Thomas Anders	genre	American Academy of Arts and Letters
Jean Le Rond d'Alembert	occupation	Academia Europaea
Czech Republic	member of	Organisation for Economic Cooperation and Development
Zooey Deschanel	occupation	World Trade Organization
Daniel Lanois	occupation	Saint Petersburg Academy of Sciences
Tim Rice-Oxley	genre	English
Susan Sontag	diplomatic relation	International Finance Corporation
Valeriya Novodvorskaya	diplomatic relation	German Academy of Sciences Leopoldina
Antonin Artaud	country of citizenship	Czech
Ulrich von Wilamowitz-Moellendorff	place of birth	Singapore
Satyajit Ray	diplomatic relation	Saint Petersburg Academy of Sciences
Malawi	member of	English
Sara Bareilles	diplomatic relation	English
Gene Simmons	occupation	English
William S. Burroughs	diplomatic relation	Royal Netherlands Academy of Arts and Sciences
Paula Abdul	educated at	English
Shania Twain	country of citizenship	Royal Swedish Academy of Sciences
Nelly Furtado	diplomatic relation	United States of America
Noam Chomsky	instrument	Academy of Sciences of Turin
Gretchen Wilson	influenced by	Russian
Anatoly Lunacharsky	diplomatic relation	African Development Bank
Kylie Minogue	record label	United Kingdom of Great Britain and Ireland
Giorgio Gaber	occupation	Bavarian Academy of Sciences and Humanities
George Eliot	place of death	Communist Party of the Soviet Union
Frédéric Joliot-Curie	member of	Caribbean Development Bank
Trinidad and Tobago	ethnic group	Royal Swedish Academy of Sciences
Dominica	educated at	English
Yevgeny Zamyatin	member of	United States of America
Lianne La Havas	occupation	English
Whitney Houston	occupation	English
Henri Victor Regnault	genre	Communist Party of the Soviet Union
Franz Miklosich	occupation	Alliance of Small Island States
Canada	occupation	International Centre for Settlement of Investment Disputes
Enzo Jannacci	diplomatic relation	German Academy of Sciences Leopoldina
Peter Kropotkin	place of death	English
Libya	occupation	Organisation internationale de la Francophonie
Charles Babbage	place of death	Group on Earth Observations
Trey Parker	member of	Bavarian Academy of Fine Arts
Kate Bush	member of	American Academy of Arts and Sciences
Maxim Gorki	record label	English
Michel de Montaigne	genre	French
Carl Peter Thunberg	member of	English
East Timor	diplomatic relation	English
André-Marie Ampère	genre	Royal Prussian Academy of Sciences
Wilhelm Grimm	languages spoken, written, or signed	Latin
Justin Timberlake	diplomatic relation	United Kingdom of Great Britain and Ireland
Christa Wolf	member of	International Finance Corporation
John Farnham	educated at	Group on Earth Observations
Slovakia	member of	English
John Cameron Mitchell	member of	English
Frédéric Chopin	member of	German
Gladys Knight	languages spoken, written, or signed	German
Djibouti	influenced by	Russian
Taraneh Javanbakht	genre	Pontifical Academy of Sciences
Van McCoy	occupation	Royal Prussian Academy of Sciences
Monaco	diplomatic relation	American Academy of Arts and Letters
AJ Michalka	occupation	Communist Party of the Soviet Union
Theodor Mommsen	occupation	Commonwealth of Nations
Rickie Lee Jones	member of	Organisation of Islamic Cooperation
Jack London	occupation	Academy of Sciences of Turin
Greece	field of work	Multilateral Investment Guarantee Agency
Barbra Streisand	record label	English
Macy Gray	languages spoken, written, or signed	American Academy of Arts and Sciences
The Edge	diplomatic relation	International Finance Corporation
Lil' Kim	diplomatic relation	English
Khloé Kardashian	residence	German
Gordon Parks	record label	English
Geddy Lee	occupation	International Telecommunication Union
Rob Reiner	diplomatic relation	International Finance Corporation
Yeshayahu Leibowitz	diplomatic relation	International Telecommunication Union
People's Republic of China	member of	Saint Petersburg Academy of Sciences
Gore Vidal	diplomatic relation	English
United States of America	diplomatic relation	Ukraine
Keren Ann	occupation	English
Barbados	member of	World Trade Organization
James Franco	occupation	Saint Petersburg Academy of Sciences
United States of America	occupation	North Korea
Robbie Robertson	occupation	English
Armenia	member of	American Academy of Arts and Sciences
Tex Ritter	diplomatic relation	English
Brad Delson	member of	International Finance Corporation
Phil Harris	field of work	Royal Netherlands Academy of Arts and Sciences
Ricky Nelson	continent	United States of America
Bhimrao Ramji Ambedkar	genre	United Nations
Norway	field of work	Multilateral Investment Guarantee Agency
Olivier Messiaen	educated at	Communist Party of the Soviet Union
Woody Guthrie	diplomatic relation	English
David Lindley	influenced by	English
Jimmy Fallon	member of	Organisation of Islamic Cooperation
Grenada	occupation	Group on Earth Observations
Darius Milhaud	occupation	French Academy of Sciences
Joss Stone	languages spoken, written, or signed	German
Serbia	genre	Multilateral Investment Guarantee Agency
Tunisia	member of	Bavarian Academy of Sciences and Humanities
Fritz Leiber Junior	member of	Academy of Sciences of Turin
James Taylor	influenced by	International Telecommunication Union
Michael Mann	country of citizenship	Royal Prussian Academy of Sciences
Suriname	diplomatic relation	OHADA
Albrecht von Haller	member of	United States of America
Nikolay Ogarev	occupation	French
Trent Reznor	member of	German Academy of Sciences Leopoldina
Sofia Kovalevskaya	diplomatic relation	National Academy of Sciences
Iggy Pop	languages spoken, written, or signed	World Trade Organization
Richard Stallman	diplomatic relation	French
Sidney Poitier	genre	English
Madonna	occupation	People's Republic of China
Kingdom of the Netherlands	instrument	German
Ivan Turgenev	occupation	English
Sir George Stokes, 1st Baronet	diplomatic relation	University of Jena
Croatia	member of	Organisation internationale de la Francophonie
Leon Russell	occupation	Royal Swedish Academy of Sciences
Alexander Emanuel Agassiz	occupation	French
Henri Bergson	country of citizenship	United States of America
Karel Čapek	occupation	Saint Petersburg Academy of Sciences
Kosovo	member of political party	Mikhail Lermontov
Qatar	record label	United States of America
Selena Gomez	country of citizenship	German
Lion Feuchtwanger	occupation	French
Nyusha	diplomatic relation	United States of America
Will Smith	occupation	English
Steven Van Zandt	occupation	Czech
Bhimrao Ramji Ambedkar	influenced by	Decca
Pakistan	educated at	United States of America
Melanie C	field of work	English
Brian May	occupation	International Telecommunication Union
Kingdom of the Netherlands	languages spoken, written, or signed	French
Ray Bradbury	place of birth	English
Kinky Friedman	member of	International Finance Corporation
Avery Brooks	country of citizenship	English
Clarence "Gatemouth" Brown	occupation	English
Rob Zombie	occupation	Group on Earth Observations
W. H. Auden	ethnic group	Council of Europe
Ivan Yefremov	member of	World Trade Organization
Mýa	occupation	English
Greece	occupation	People's Republic of China
Kris Kristofferson	occupation	English
Rita Levi-Montalcini	occupation	Saint Petersburg Academy of Sciences
Peter Gay	occupation	Academy of Sciences of Turin
Theodore von Kármán	diplomatic relation	United States of America
Sir George Stokes, 1st Baronet	place of death	English
Walker Percy	diplomatic relation	Arab Bank for Economic Development in Africa
Robert Downey, Jr.	occupation	International Finance Corporation
Pierre-Simon Laplace	occupation	Group on Earth Observations
Dominica	occupation	North Macedonia
United States of America	occupation	English
Sheldon Lee Glashow	member of	English
Alan Stivell	member of	German Academy of Sciences Leopoldina
Veniamin Smekhov	country of citizenship	English
Dolly Parton	instrument	Multilateral Investment Guarantee Agency
Vladislav Krapivin	occupation	German
Moldova	occupation	French
Mikhail Vassilyevich Lomonosov	diplomatic relation	French
Jô Soares	record label	International Hydrographic Organization
Johann Christoph Gottsched	occupation	International Development Association
Aram Khachaturian	place of death	Russian
Jamie Foxx	sibling	United Nations
Tomáš Garrigue Masaryk	occupation	Phi Beta Kappa Society
L. Frank Baum	diplomatic relation	Council of Europe
Adriano Celentano	record label	French
Octavio Paz	occupation	Saint Petersburg Academy of Sciences
Donald Glover	occupation	English
Joni Mitchell	occupation	International Finance Corporation
Sarah McLachlan	occupation	English
Miranda Cosgrove	occupation	Communist Party of the Soviet Union
Louis Armstrong	diplomatic relation	Royal Swedish Academy of Sciences
Ukraine	occupation	English
Cuba	country of citizenship	United States of America
Dmitri Shostakovich	occupation	Peter Kropotkin
Uzbekistan	member of	Saint Petersburg Academy of Sciences
Dennis Hopper	occupation	Organisation for Economic Cooperation and Development
Severo Ochoa	occupation	English
Rita Levi-Montalcini	occupation	Russian Academy of Sciences
India	member of	Universal Postal Union
Jean-Baptiste Dumas	languages spoken, written, or signed	São Tomé and Príncipe
Neil Gaiman	member of	Bavarian Academy of Fine Arts
Indonesia	diplomatic relation	English
United States of America	member of	synth-pop
Yegor Letov	diplomatic relation	Royal Swedish Academy of Sciences
William Thomson, 1st Baron Kelvin	occupation	science fiction writer
Lewis Carroll	occupation	United States of America
Debby Ryan	occupation	United States of America
Bangladesh	occupation	African Union – United Nations Hybrid Operation in Darfur
Yehudi Menuhin	instrument	Universal Postal Union
Aleksandr Solzhenitsyn	occupation	Universal Postal Union
Andrei Tarkovsky	occupation	Saint Petersburg Academy of Sciences
David Brewster	languages spoken, written, or signed	English
Ric Ocasek	member of	World Trade Organization
Adam Lambert	occupation	English
Abraham Gotthelf Kästner	occupation	European Southern Observatory
Italy	occupation	Multilateral Investment Guarantee Agency
El Salvador	occupation	Democratic Party
Avicii	employer	French Academy of Sciences
United States of America	diplomatic relation	G. K. Chesterton
Jaan Kaplinski	country of citizenship	Universal Postal Union
Switzerland	occupation	English
Dorothy L. Sayers	occupation	International Finance Corporation
Busta Rhymes	occupation	United States of America
Jan Evangelista Purkyně	genre	African Development Bank
Ivan Illich	occupation	United States of America
Mircea Eliade	record label	Multilateral Investment Guarantee Agency
Joaquim Maria Machado de Assis	occupation	film editor
Jennette McCurdy	instrument	World Trade Organization
Myles Kennedy	diplomatic relation	Organisation of Islamic Cooperation
James D. Watson	genre	Group on Earth Observations
Rwanda	diplomatic relation	International Finance Corporation
Glukoza	member of	United Kingdom of Great Britain and Ireland
Julio Iglesias	diplomatic relation	Royal Netherlands Academy of Arts and Sciences
M. Pokora	occupation	Group on Earth Observations
Jacques Derrida	diplomatic relation	German
North Macedonia	occupation	International Finance Corporation
Papua New Guinea	cast member	African Development Bank
Willow Smith	diplomatic relation	English
Nicki Minaj	occupation	German Academy of Sciences Leopoldina
Antigua and Barbuda	diplomatic relation	Taiwan
Holly Near	ethnic group	United Nations
Joe Cocker	genre	Saint Petersburg Academy of Sciences
Cliff Richard	occupation	United States of America
Mohandas Karamchand Gandhi	occupation	English
Trey Parker	religion	African Development Bank
Trinidad and Tobago	diplomatic relation	United States of America
Lea Michele	influenced by	English
Peter Drucker	occupation	Russian
Tyler, the Creator	occupation	Saint Petersburg Academy of Sciences
Peter Tork	diplomatic relation	International Telecommunication Union
Jerry Reed	country of citizenship	English
Benoit Mandelbrot	diplomatic relation	United States of America
Saudi Arabia	diplomatic relation	American Academy of Arts and Sciences
D. H. Lawrence	occupation	Georg Wilhelm Friedrich Hegel
Fritz Haber	diplomatic relation	Group on Earth Observations
Barthold Georg Niebuhr	country of citizenship	Federated States of Micronesia
Saint Kitts and Nevis	languages spoken, written, or signed	Visa Waiver Program
United States of America	diplomatic relation	International Finance Corporation
Melchior de Vogüé	influenced by	Washington, D.C.
Albert Szent-Györgyi	influenced by	renal insufficiency
Valery Leontiev	cause of death	French Academy of Sciences
Lev Gumilyov	diplomatic relation	French
Ukraine	languages spoken, written, or signed	French
Arthur Schopenhauer	diplomatic relation	English
David Hemmings	occupation	World Trade Organization
Ian McLagan	occupation	German Academy of Sciences Leopoldina
Theodor Nöldeke	diplomatic relation	French Academy of Sciences
Woody Guthrie	genre	Royal Netherlands Academy of Arts and Sciences
Ilya Oleynikov	occupation	English
Thailand	instrument	French
Ludwig Wittgenstein	member of	International Telecommunication Union
Doris Lessing	influenced by	English
Manfred Eigen	diplomatic relation	German
John Turturro	occupation	Republican Party
Saint Vincent and the Grenadines	genre	Pakistan
Noam Chomsky	occupation	English
Monaco	diplomatic relation	English
Stephen Jay Gould	diplomatic relation	Universal Postal Union
Hector Berlioz	diplomatic relation	German
England	country of citizenship	"University of California, Los Angeles"
Julian Lennon	member of	Group on Earth Observations
Friedrich Schlegel	occupation	German
Jill Scott	record label	German
Adolf Erik Nordenskiöld	residence	United States of America
Austria	occupation	International Telecommunication Union
Israel	diplomatic relation	English
Penny Marshall	member of	Missile Technology Control Regime
Vladimir Vysotsky	diplomatic relation	French
Peter Kropotkin	country of citizenship	French
Ferdinand von Richthofen	member of	European Southern Observatory
Kenya	member of	Universal Postal Union
Levon Helm	instrument	American Academy of Arts and Sciences
Franz Miklosich	place of death	International Development Association
Slovenia	member of	English
Chris Martin	genre	Royal Netherlands Academy of Arts and Sciences
Jerry Lee Lewis	ethnic group	United States of America
Czech Republic	country of citizenship	Academy of Sciences of Turin
People's Republic of China	religion	English
David Attenborough	diplomatic relation	Royal Swedish Academy of Sciences
Stacie Orrico	employer	French
Ricky Nelson	genre	United States of America
Immanuel Kant	occupation	International Development Association
Satyajit Ray	ethnic group	German
Turkey	genre	American Academy of Arts and Sciences
Jacobus Henricus van 't Hoff	occupation	Romanticism
Nick Cannon	occupation	Royal Prussian Academy of Sciences
Kelly Rowland	occupation	Russian Academy of Sciences
Frédéric Chopin	languages spoken, written, or signed	American Academy of Arts and Sciences
Vitaly Ginzburg	genre	Royal Prussian Academy of Sciences
Jaden Smith	languages spoken, written, or signed	English
Dominican Republic	occupation	United States of America
Berry Gordy	occupation	United States of America
Ayọ	member of	French
Sarah McLachlan	member of	English
Botswana	occupation	German
Jada Pinkett Smith	occupation	English
Howard Hughes	occupation	English
Kurt Vonnegut	diplomatic relation	German
Chris Cornell	occupation	English
Billie Holiday	place of burial	Royal Swedish Academy of Sciences
Somalia	occupation	Universal Postal Union
Ayọ	diplomatic relation	Organisation internationale de la Francophonie
Bret Easton Ellis	member of	Universal Postal Union
Timbaland	occupation	French
People's Republic of China	residence	United States of America
Ilya Oleynikov	instrument	Novodevichy Cemetery
Édouard René de Laboulaye	occupation	International Development Association
Saudi Arabia	occupation	United States of America
Joe Satriani	diplomatic relation	Academy of Arts of the GDR
Sven Hedin	occupation	United States of America
Guatemala	member of	Southern African Development Community
Libya	diplomatic relation	United States of America
Gaspard de Prony	occupation	English
Brad Pitt	occupation	English
Anna Akhmatova	occupation	Organization of American States
Azerbaijan	country of citizenship	World Trade Organization
Japan	member of	United States of America
Alberto Manguel	occupation	Novodevichy Cemetery
Albert Einstein	diplomatic relation	United States of America
Natalie Portman	diplomatic relation	English
Camillo Golgi	cause of death	Royal Society of Literature
Geoffrey Ingram Taylor	occupation	Group on Earth Observations
Igor Stravinsky	country	Italian
Henri Poincaré	languages spoken, written, or signed	Russian
Hannah Arendt	occupation	United States of America
Mihajlo Pupin	genre	Hebrew
Anastacia	occupation	International Development Association
André-Marie Ampère	educated at	United States of America
Rita Levi-Montalcini	member of	Mercury Records
Donald Knuth	influenced by	Pontifical Academy of Sciences
Myanmar	occupation	English
United Arab Emirates	record label	Göttingen Academy of Sciences
Gerald Wilson	ethnic group	International Finance Corporation
Kenya	place of birth	International Development Association
Cat Stevens	place of death	Asian Development Bank
Carl Friedrich von Weizsäcker	diplomatic relation	Hispanic America
Albert Camus	occupation	Communist Party of the Soviet Union
Raven-Symoné	occupation	United States of America
Jaden Smith	official language	Bavarian Academy of Sciences and Humanities
Robin Williams	instrument	United States of America
Graham Greene	member of	German Academy of Sciences Leopoldina
Alla Pugacheva	member of	International Development Association
Romania	occupation	English
Hermann Burmeister	genre	French
Patti Smith	member of	United States of America
Urbain Le Verrier	diplomatic relation	Treaty on Open Skies
William Thomson, 1st Baron Kelvin	member of	Holy See
Lianne La Havas	languages spoken, written, or signed	Arab Monetary Fund
James Brown	genre	German
Wolfgang Schadewaldt	occupation	Council of Europe
Saint Vincent and the Grenadines	occupation	musical composition
Robert Louis Stevenson	languages spoken, written, or signed	French
Algeria	diplomatic relation	German
Salvador de Madariaga	member of	International Development Association
Moby	member of	Universal Postal Union
Barbara Mandrell	influenced by	Russian
Indonesia	diplomatic relation	American Academy of Arts and Sciences
Saint Lucia	member of	French
Theodosius Dobzhansky	educated at	English
Berry Gordy	country of citizenship	Bavarian Academy of Fine Arts
Buckethead	diplomatic relation	United States of America
Barry Manilow	member of	World Trade Organization
Bob Hope	diplomatic relation	United States of America
Mos Def	instrument	French
Canada	member of	English
United Arab Emirates	cause of death	European Space Agency
Leo Tolstoy	religion	African Union – United Nations Hybrid Operation in Darfur
Vanessa Carlton	member of	United States of America
Vince Neil	occupation	Multilateral Investment Guarantee Agency
Søren Kierkegaard	instrument	Saint Petersburg Academy of Sciences
India	occupation	International Bank for Reconstruction and Development
Malta	occupation	English
Ethiopia	member of	Universal Postal Union
Rabindranath Tagore	diplomatic relation	Academy of Sciences of Turin
Ilya Ehrenburg	member of	International Development Association
Philippines	diplomatic relation	Organisation of Islamic Cooperation
Jerry Garcia	occupation	German
Johnny Cash	member of	Asian Development Bank
Thailand	member of political party	Royal Netherlands Academy of Arts and Sciences
J. M. Coetzee	occupation	French
Norman Mailer	occupation	Royal Prussian Academy of Sciences
František Palacký	languages spoken, written, or signed	English people
Edmund Wilson	diplomatic relation	Academy of Sciences of Turin
Avicii	country of citizenship	Royal Swedish Academy of Sciences
Albania	member of	Group on Earth Observations
Liberia	occupation	Saint Petersburg Academy of Sciences
Germany	country of citizenship	Multilateral Investment Guarantee Agency
Chuck Berry	occupation	Italian
Henry Louis Gates	genre	German
Kate Voegele	diplomatic relation	English
Jean Renoir	instrument	United States of America
United Kingdom	diplomatic relation	International Finance Corporation
Kirsten Dunst	diplomatic relation	International Development Association
Cambodia	instrument	Universal Postal Union
Charles Baudelaire	country of citizenship	Italian
Libya	diplomatic relation	English
United States of America	occupation	Angola
Peter Tork	place of birth	United States of America
David Ogden Stiers	educated at	Saint Petersburg Academy of Sciences
Cliff Richard	instrument	Organisation of Islamic Cooperation
Adam Ant	genre	International Hydrographic Organization
Jordin Sparks	occupation	Italian
Christoph Wilhelm Hufeland	member of	American Philosophical Society
United Arab Emirates	record label	Arab Monetary Fund
Libya	occupation	American Academy of Arts and Letters
Steven Seagal	occupation	International Development Association
Oman	educated at	International Finance Corporation
Afghanistan	languages spoken, written, or signed	United States of America
John Locke	record label	International Hydrographic Organization
The Edge	record label	musical composition
George Eliot	occupation	United States of America
Central African Republic	country of citizenship	Asian Development Bank
United States of America	diplomatic relation	English
Alberto Manguel	occupation	United Nations
Jan Evangelista Purkyně	occupation	Immanuel Kant
Jean-Baptiste Biot	member of	National Academy of Sciences
New Zealand	occupation	Equatorial Guinea
Denmark	ethnic group	United States of America
Renaud	genre	Democratic Party
Nepal	member of	Russian
Athanasius Kircher	diplomatic relation	International Finance Corporation
Vanessa Williams	member of	World Trade Organization
Jewel	member of	Russian
Woody Allen	instrument	Lincean Academy
Billy Connolly	occupation	French
North Korea	influenced by	French Academy of Sciences
Akiko Yano	occupation	World Trade Organization
Selma Lagerlöf	place of death	Universal Postal Union
Max Born	residence	Universal Postal Union
William Faulkner	cause of death	Treaty on Open Skies
Joseph Louis Gay-Lussac	member of	Nigeria
Jorge Luis Borges	genre	Saint Petersburg Academy of Sciences
André 3000	instrument	United States of America
Palau	place of birth	United States of America
Sri Lanka	employer	English
David Brewster	occupation	World Trade Organization
Syria	instrument	German
John William Strutt, 3rd Baron Rayleigh	occupation	Venezuela
Philip Pullman	member of	Royal Prussian Academy of Sciences
Bella Thorne	occupation	English
Sri Lanka	diplomatic relation	English
Yoshiki	occupation	United States of America
South Africa	member of	English
Nicaragua	diplomatic relation	United States of America
Omar Sharif	occupation	"University of California, Los Angeles"
Levon Helm	member of	International Finance Corporation
Marlene Dietrich	instrument	Latin
Moritz von Jacobi	occupation	Communist Party of the Soviet Union
Sarah Silverman	country of citizenship	International Development Association
CeeLo Green	diplomatic relation	Royal Swedish Academy of Sciences
Greece	occupation	Organisation internationale de la Francophonie
Juilliard School	diplomatic relation	Holy See
Dalida	continent	American Academy of Arts and Sciences
Evelyn Waugh	place of death	People's Republic of China
Jeff Goldblum	educated at	Universal Postal Union
Ciara	occupation	International Development Association
Sierra Leone	employer	English
Bulgaria	member of	English
Jan Hammer	occupation	Russian
David Byrne	occupation	International Finance Corporation
Robert Penn Warren	occupation	Arab Bank for Economic Development in Africa
Chord Overstreet	occupation	German
Jan Rubes	genre	Organization of American States
Danny Glover	occupation	English
Jim Morrison	record label	Organisation of Islamic Cooperation
Switzerland	member of	United States of America
Ross Bagdasarian Sr.	country of citizenship	Parlophone
Katy Perry	diplomatic relation	Royal Prussian Academy of Sciences
Connie Francis	residence	Russian Academy of Sciences
Namibia	diplomatic relation	Commonwealth of Nations
Central African Republic	country of citizenship	French Academy of Sciences
Sergey Mikhalkov	diplomatic relation	United States of America
Yo-Yo Ma	diplomatic relation	Royal Swedish Academy of Sciences
Bolivia	occupation	Royal Prussian Academy of Sciences
United States of America	diplomatic relation	United States of America
Czesław Miłosz	diplomatic relation	Luxembourg
Fergie	occupation	Latin
Central African Republic	diplomatic relation	Père Lachaise Cemetery
Debbie Harry	member of	United States of America
Australia	occupation	American Academy of Arts and Sciences
Oman	genre	American Academy of Arts and Sciences
Jessica Simpson	instrument	French
Vincent Gallo	occupation	United States of America
David A. Stewart	occupation	World Trade Organization
Mike Shinoda	languages spoken, written, or signed	20th century
Robert Schumann	employer	United States of America
Allen Ginsberg	member of	Movement Coordination Centre Europe
Falco	influenced by	Organisation internationale de la Francophonie
Lionel Richie	country of citizenship	Universal Postal Union
John Muir	country of citizenship	Saint Petersburg Academy of Sciences
Samoa	occupation	English
Joseph-Louis Lagrange	record label	Royal Society of Literature
Republic of Cyprus	occupation	International Finance Corporation
Colbie Caillat	member of	Australia Group
Leon Battista Alberti	spouse	Royal Prussian Academy of Sciences
Carl Friedrich von Weizsäcker	record label	African Development Bank
Dorothy L. Sayers	member of	Hungarian
Selena Gomez	member of	United Kingdom of Great Britain and Ireland
Tex Ritter	member of	United States of America
J. R. R. Tolkien	part of	English
David Hume	country of citizenship	National Academy of Sciences
Canada	country of citizenship	English
Busta Rhymes	languages spoken, written, or signed	International Development Association
Bo Burnham	occupation	United States of America
Lithuania	occupation	United States of America
Mexico	diplomatic relation	International Telecommunication Union
Claude Lévi-Strauss	instrument	United States of America
Jean-Victor Poncelet	country	American Philosophical Society
Phil Harris	country of citizenship	English
Guatemala	diplomatic relation	United Arab Emirates
Sean Combs	diplomatic relation	English
Julio Cortázar	occupation	Group on Earth Observations
Howard Hughes	instrument	United States of America
Barbra Streisand	genre	United States of America
Jean-Victor Poncelet	occupation	Middle East
Mýa	occupation	German
People's Republic of China	diplomatic relation	French
United States of America	genre	United States of America
will.i.am	occupation	Stendhal
Nauru	member of	United States of America
John Cale	diplomatic relation	Royal Prussian Academy of Sciences
Anatoly Lunacharsky	educated at	literary realism
Charles Bukowski	place of death	International Hydrographic Organization
Maldives	occupation	International Finance Corporation
São Tomé and Príncipe	occupation	Saint Petersburg Academy of Sciences
Gloria Trevi	genre	National Academy of Sciences
Iraq	occupation	Arab Fund for Economic and Social Development
MC Hammer	occupation	Alliance of Small Island States
Charles Aznavour	member of	International Energy Agency
Debbie Gibson	employer	International Hydrographic Organization
Jean-Baptiste Biot	occupation	English
Ukraine	genre	International Telecommunication Union
Alice Walker	occupation	Latin
Wilhelm Blaschke	occupation	Academy of Sciences of the USSR
Roman Jakobson	occupation	International Energy Agency
Phil Collins	diplomatic relation	United States of America
Euclides da Cunha	languages spoken, written, or signed	United States of America
Joseph Liouville	occupation	German
United States of America	languages spoken, written, or signed	Academy of Sciences of Turin
Ivan Turgenev	member of	International Finance Corporation
GoonRock	occupation	Universal Postal Union
Henrik Steffens	occupation	Russian
Ciara	member of	Italian
Iran	member of political party	American Academy of Arts and Letters
Eldar Ryazanov	occupation	Universal Postal Union
Albert Camus	place of birth	World Trade Organization
United States of America	influenced by	Princeton University
Miley Cyrus	genre	Latin
Sandy	member of	United States of America
Gabriel García Márquez	member of	Saint Petersburg Academy of Sciences
Ivan Yefremov	member of political party	Democratic Party
Oleg Skripka	diplomatic relation	English
North Korea	diplomatic relation	Jean Cocteau
Theodore von Kármán	diplomatic relation	Mali
Emma Bunton	member of	Asian Development Bank
Central African Republic	member of	Guinea
Lewis Carroll	instrument	United States of America
Iran	occupation	German
Andy Williams	member of	UNESCO
Austrian Empire	occupation	United States of America
Brazil	diplomatic relation	English
Kris Kristofferson	occupation	Hebrew
Walt Disney	country of citizenship	Italian
Julio Cortázar	occupation	Russian Academy of Sciences
Sir George Stokes, 1st Baronet	occupation	Russian
Estonia	occupation	United States of America
Thomas Aquinas	member of	French
Lemmy Kilmister	diplomatic relation	Universal Postal Union
Samuel R. Delany	occupation	Council of Europe
Billy Connolly	country of citizenship	United States of America
George Ellery Hale	member of	Italian
Darren Criss	record label	Russian Soviet Federative Socialist Republic
Burkina Faso	instrument	Russian
Libya	influenced by	Russian
Andriy Danylko	cause of death	United States of America
Uganda	diplomatic relation	English
Walt Disney	headquarters location	World Trade Organization
Yevgeny Yevtushenko	cause of death	Portuguese
Zoolander	diplomatic relation	European Space Agency
North Macedonia	diplomatic relation	Asian Development Bank
Gaspard de Prony	occupation	Hollywood Records
Boris Grebenshchikov	diplomatic relation	El Salvador
Chile	languages spoken, written, or signed	French
Yukio Mishima	occupation	International Finance Corporation
Nat King Cole	diplomatic relation	Organization of American States
Simon Newcomb	diplomatic relation	United States of America
Romania	diplomatic relation	Universal Postal Union
Franz Kafka	occupation	Italian
Viggo Mortensen	country of citizenship	French
Shakira	occupation	World Trade Organization
Mikhail Zadornov	country of citizenship	Royal Prussian Academy of Sciences
Uzeyir Hajibeyov	genre	World Trade Organization
Iceland	member of	German
Seychelles	diplomatic relation	Russian Academy of Sciences
Yoko Ono	genre	World Trade Organization
Ferdinand von Richthofen	diplomatic relation	United States of America
Mexico	diplomatic relation	American Academy of Arts and Sciences
Per Olov Enquist	member of	United States of America
Liberia	diplomatic relation	G20
LeToya Luckett	member of	Warner Bros. Records
Burundi	record label	Caribbean Development Bank
Dmitri Shostakovich	genre	Swedish
South Korea	member of	French
Ludwig Prandtl	cause of death	United States of America
György Lukács	member of	International Energy Agency
Liberace	occupation	French
Harry Chapin	official language	United States of America
Alexander R. Todd, Baron Todd	member of	Kevin Jonas
Michael Nesmith	occupation	Polish
Avicii	genre	National Academy of Sciences
Russia	influenced by	American Academy of Arts and Sciences
Ed Sheeran	occupation	German
Jann Arden	occupation	Père Lachaise Cemetery
Peter Ustinov	diplomatic relation	G20
Gustav Landauer	languages spoken, written, or signed	Saint Petersburg Academy of Sciences
Hanns Eisler	diplomatic relation	United States of America
Georges Cuvier	occupation	United States of America
Mary J. Blige	diplomatic relation	musical composition
Lithuania	influenced by	United States of America
Dorothy L. Sayers	diplomatic relation	Russian Academy of Sciences
Lesotho	ethnic group	Guinea-Bissau
Shaquille O'Neal	diplomatic relation	World Trade Organization
Iraq	member of	African Development Bank
Fritz Lang	member of	National Academy of Sciences
Lionel Richie	instrument	French
Sweden	genre	Société Philomathique de Paris
Kiely Williams	country of citizenship	United States of America
Jamaica	influenced by	Universal Postal Union
Harry Connick Jr.	diplomatic relation	United States of America
Julie Delpy	occupation	United States of America
United Arab Emirates	diplomatic relation	South Korea
Jaan Kaplinski	country	United States of America
Don Rickles	occupation	World Trade Organization
Senegal	member of	United States of America
Mongolia	diplomatic relation	United States of America
Hugo Huppert	occupation	United States of America
Henry Louis Le Châtelier	member of	Italian
John Travolta	member of	musical composition
Stephen Spender	country	musical composition
Russia	diplomatic relation	English
Equatorial Guinea	country of citizenship	English
Yukio Mishima	record label	International Development Association
Joseph Louis Gay-Lussac	sibling	musical composition
Robert Frost	diplomatic relation	Russian Academy of Sciences
Claudio Magris	occupation	French
Giorgio Gaber	occupation	English
Bangladesh	occupation	Multilateral Investment Guarantee Agency
Mary Wollstonecraft	occupation	Treaty on Open Skies
John Cassavetes	languages spoken, written, or signed	Democratic Party
Mstislav Keldysh	member of	Kingdom of Prussia
Celeste Buckingham	member of	English
Boris Grebenshchikov	member of	San Francisco
Jean Gaston Darboux	languages spoken, written, or signed	Nuclear Suppliers Group
Jordan	occupation	Russian
Denmark	diplomatic relation	English
T. S. Eliot	member of	Myanmar
George Frideric Handel	member of	English
Denmark	influenced by	Organization for Security and Co-operation in Europe
Jim Belushi	occupation	Elizabeth II
North Korea	member of	National Academy of Sciences
Dominican Republic	member of	Karl Marx
Camille Saint-Saëns	member of	Republican Party
Robert McNamara	country of citizenship	World Trade Organization
Bruce Springsteen	occupation	singer-songwriter
Herbert Grönemeyer	member of	French
Augustine of Hippo	genre	Göttingen Academy of Sciences
United States of America	diplomatic relation	Interpol
Paulo Coelho	occupation	English
Holly Johnson	cast member	Royal Prussian Academy of Sciences
New Zealand	ethnic group	United States of America
Jean Yanne	instrument	International Finance Corporation
Maria Callas	instrument	United States of America
Sara Bareilles	place of death	African Development Bank
Philip Roth	occupation	International Development Association
India	occupation	United States of America
Léo Ferré	diplomatic relation	United States of America
Richard Marx	instrument	United States of America
Pakistan	diplomatic relation	English
Stephen Spender	diplomatic relation	Père Lachaise Cemetery
Valentin Kataev	movement	French
Indonesia	languages spoken, written, or signed	German
Venezuela	diplomatic relation	Alliance of Small Island States
Richard Wright	medical condition	Royal Prussian Academy of Sciences
Ross Bagdasarian Sr.	occupation	Samuel Beckett
Fyodor Dostoyevsky	diplomatic relation	Trinidad and Tobago
Rick Rubin	occupation	German
Uruguay	occupation	English
Lucy Liu	diplomatic relation	Academy of Sciences of Turin
Kurt Weill	occupation	Universal Postal Union
Brunei	languages spoken, written, or signed	German
Jaan Kaplinski	occupation	Russian Academy of Sciences
Ivory Coast	instrument	French
Bella Thorne	occupation	African Americans
Mýa	member of	"University of California, Los Angeles"
Georgia	diplomatic relation	United States of America
Mikhail Bakunin	occupation	Italian
Vladimir Vysotsky	member of	Russian Academy of Sciences
Paul Valéry	diplomatic relation	Saint Petersburg Academy of Sciences
Guinea	instrument	United States of America
Serbia	instrument	Accademia Nazionale delle Scienze detta dei XL
Ivan Yefremov	diplomatic relation	Universal Postal Union
Oswald Heer	country of citizenship	English
Sheldon Lee Glashow	occupation	United States of America
Tunisia	occupation	International Development Association
Lily Allen	occupation	Novodevichy Cemetery
Michel Legrand	diplomatic relation	Missile Technology Control Regime
Levon Helm	diplomatic relation	International Finance Corporation
Damon Albarn	instrument	United States of America
Jean-Baptiste Dumas	languages spoken, written, or signed	United States of America
Greece	occupation	Organisation for Economic Cooperation and Development
Heinrich Brunner	country	Arab Fund for Economic and Social Development
Béla Bartók	member of	United States of America
Jason Mraz	diplomatic relation	International Finance Corporation
Libya	member of political party	German
MC Hammer	occupation	French
Montenegro	occupation	Samoa
Peru	place of birth	English
Albert Szent-Györgyi	instrument	International Finance Corporation
Republic of the Congo	place of death	Humboldt University of Berlin
T-Bone Walker	record label	Academy of Arts, Berlin
Dmitri Shostakovich	occupation	Haruki Murakami
Fritz Haber	country of citizenship	Arab Bank for Economic Development in Africa
Walker Percy	instrument	International Hydrographic Organization
Saint Kitts and Nevis	instrument	lung cancer
Nauru	member of	United States of America
Arthur Schopenhauer	diplomatic relation	United States of America
Leopold von Ranke	occupation	Spanish
Roger Miller	cause of death	"University of California, Los Angeles"
John Cleese	member of	United States of America
Mozambique	member of	French
Simon Newcomb	diplomatic relation	National Academy of Sciences
Ray Bradbury	record label	20th century
Fredro Starr	genre	Universal Postal Union
Nikolay Ogarev	influenced by	Royal Swedish Academy of Sciences
Jorge Amado	genre	Saint Petersburg Academy of Sciences
Josephine Baker	diplomatic relation	United States of America
Burundi	occupation	German
Saul Williams	occupation	French
Boris Vian	residence	Group on Earth Observations
Nicki Minaj	member of	Russian Academy of Sciences
Sebastian Haffner	diplomatic relation	Nuclear Suppliers Group
Alfred Einstein	occupation	Alliance of Small Island States
Enrique Iglesias	member of	contemporary R&B
Jules Verne	member of	Universal Postal Union
Gottfried Wilhelm Leibniz	record label	G. K. Chesterton
United States of America	field of work	soul music
Nick Jonas	country of citizenship	Universal Postal Union
Slavoj Žižek	member of	Blaise Pascal
Capitol Records	occupation	musicologist
Leonard Nimoy	diplomatic relation	Warner Bros. Records
Benjamin Franklin	record label	United States of America
Italy	continent	People's Republic of China
Somalia	instrument	Latin
Denmark	country of citizenship	English
Belize	diplomatic relation	Russian
Theodore Roosevelt	country of citizenship	English
Mark Ronson	member of political party	Commonwealth of Nations
Hannah Arendt	diplomatic relation	German
Julieta Venegas	sibling	English
François-René de Chateaubriand	occupation	astronomy
Solange Knowles	child	German
East Timor	occupation	20th century
Ernst Curtius	occupation	musical composition
Martin Buber	diplomatic relation	United States of America
Selma Lagerlöf	diplomatic relation	French
Republic of Cyprus	diplomatic relation	United States of America
Richard Marx	field of work	Democratic Party
Bret Michaels	occupation	International Development Association
Amr Diab	country of citizenship	Democratic Party
Enrique Iglesias	official language	United States of America
Debbie Harry	occupation	International Development Association
Valery Leontiev	diplomatic relation	Academy of Useful Science
Amiri Baraka	influenced by	Universal Postal Union
Christa Wolf	languages spoken, written, or signed	United States of America
Crispin Glover	country of citizenship	French
T. S. Eliot	occupation	Leipzig
Will Smith	member of	Saint Petersburg Academy of Sciences
Paul Hindemith	languages spoken, written, or signed	Universal Postal Union
Tim Rice-Oxley	influenced by	World Trade Organization
Thomas Henry Huxley	occupation	United States of America
Montenegro	occupation	World Trade Organization
Lana Del Rey	member of	UNESCO
will.i.am	member of	United States of America
Joe Dassin	occupation	Treaty on Open Skies
Nikolai Fomenko	diplomatic relation	Lincean Academy
Nicholas Marr	diplomatic relation	Royal Prussian Academy of Sciences
Felipe Colombo	genre	United States of America
James Bryant Conant	occupation	20th century
Hulk Hogan	field of work	French
Alexz Johnson	field of work	Universal Postal Union
Jean-Victor Poncelet	official language	physics
Milla Jovovich	diplomatic relation	United States of America
South Africa	occupation	African Development Bank
Dmitry Glukhovsky	record label	Dante Alighieri
Jean Gaston Darboux	genre	Liberia
Yeshayahu Leibowitz	occupation	Hong Kong
Taraneh Javanbakht	religion	United States of America
Gambia	occupation	National Academy of Sciences
Augusto Righi	diplomatic relation	United States of America
Hugh Laurie	diplomatic relation	United States of America
J. Robert Oppenheimer	occupation	United States of America
Rodion Shchedrin	occupation	Warner Bros. Records
Raven-Symoné	occupation	American Philosophical Society
Montenegro	member of	musical composition
Ludacris	instrument	Commonwealth of Nations
Éric Rohmer	cause of death	English
Lauryn Hill	occupation	National Academy of Sciences
Raven-Symoné	diplomatic relation	English
Billy Connolly	country of citizenship	Universal Postal Union
Condoleezza Rice	diplomatic relation	United Nations
Richard Stallman	member of	United States of America
Kid Rock	diplomatic relation	United States of America
Valentin Kataev	languages spoken, written, or signed	Italian
Eric Burdon	occupation	United States of America
Galileo Galilei	religion	United States of America
Aaron Copland	diplomatic relation	International Finance Corporation
Arnold Schoenberg	member of	United States of America
Gordon Parks	instrument	United States of America
George Henschel	languages spoken, written, or signed	Polish
Hong Kong	residence	singer-songwriter
Jean-Victor Poncelet	diplomatic relation	United States of America
Arthur Conan Doyle	diplomatic relation	Hungarian Academy of Sciences
Jim Messina	diplomatic relation	Organisation of Islamic Cooperation
Mali	occupation	United States of America
Alfred Schnittke	occupation	German Academy of Sciences at Berlin
Andrei Tarkovsky	occupation	English
Kinky Friedman	occupation	Saint Petersburg Academy of Sciences
John Farnham	occupation	20th century
Deryck Whibley	genre	Trinidad and Tobago
John Ciardi	educated at	Nuclear Suppliers Group
Spike Lee	languages spoken, written, or signed	English
Norman Mailer	occupation	Organisation of Islamic Cooperation
T. S. Eliot	record label	Decca
Morgan Freeman	diplomatic relation	Asian Development Bank
People's Republic of China	occupation	musical composition
Tanzania	country of citizenship	United States of America
Iran	country of citizenship	International Development Association
Mikhail Zadornov	languages spoken, written, or signed	National Academy of Sciences
Mark Wahlberg	member of	International Development Association
Henry Kissinger	occupation	United States of America
Zoolander	occupation	Democratic Republic of the Congo
David Brewster	diplomatic relation	Organization of American States
Fiji	diplomatic relation	German
Walter Scott	member of	Spanish
Bosnia and Herzegovina	diplomatic relation	Interscope Records
Indonesia	occupation	English
Latvia	influenced by	Royal Prussian Academy of Sciences
Bhutan	genre	United States of America
Pier Paolo Pasolini	occupation	Asian Development Bank
Ursula K. Le Guin	member of	United States of America
Ray Davies	languages spoken, written, or signed	Royal Swedish Academy of Sciences
Billy Connolly	occupation	United States of America
Shakira	field of work	German
Irene Cara	genre	National Academy of Sciences
Pierre-Simon Laplace	place of birth	Swizz Beatz
Christa Wolf	genre	Caribbean Development Bank
Kenny Rogers	occupation	musical composition
Amr Diab	member of	Italian
Maria Callas	occupation	musical composition
Italy	movement	English
Felipe Colombo	diplomatic relation	English
Trent Reznor	member of	AFRISTAT
Jerry Reed	occupation	World Trade Organization
Keri Hilson	residence	Italian
Switzerland	occupation	English
Anatole Abragam	country of citizenship	French
Aleksandr Solzhenitsyn	diplomatic relation	United States of America
Nicaragua	sibling	United States of America
Tim Rice-Oxley	member of	United States of America
Johnny Hallyday	occupation	United States of America
Joaquim Maria Machado de Assis	diplomatic relation	Russian Empire
Camillo Golgi	record label	World Trade Organization
Stendhal	country of citizenship	International Finance Corporation
Che Guevara	languages spoken, written, or signed	United States of America
Zambia	member of	French
Jann Arden	member of	United States of America
Saint Vincent and the Grenadines	religion	hip hop music
Philip Roth	instrument	Russian Academy of Sciences
Croatia	occupation	Bavarian Academy of Sciences and Humanities
Egypt	employer	United States of America
Angola	record label	World Trade Organization
Frédéric Joliot-Curie	field of work	Russians
Mike Myers	diplomatic relation	Asian Development Bank
Emma Bunton	occupation	Organisation of Islamic Cooperation
Stephen Jay Gould	member of	German
Jean-Baptiste Biot	occupation	agnosticism
Barbados	diplomatic relation	French
Ivan Andreyevich Krylov	instrument	United States of America
El Salvador	diplomatic relation	Vietnam
Theodor Nöldeke	country of citizenship	North Korea
Moldova	country of citizenship	Doris Lessing
Douglas Adams	country of citizenship	United States of America
Moldova	occupation	Novodevichy Cemetery
J. J. Abrams	country of citizenship	musical composition
William Dean Howells	languages spoken, written, or signed	G20
Niger	occupation	German
Carrie Underwood	occupation	United States of America
Liechtenstein	member of	Russian Empire
Busta Rhymes	cause of death	United Nations
Melchior de Vogüé	occupation	librettist
James Bryant Conant	diplomatic relation	Russian Academy of Sciences
Walt Disney	occupation	20th century
Jason Mraz	occupation	Lincean Academy
Janet Jackson	member of	United States of America
Bob Seger	instrument	International Finance Corporation
Belarus	occupation	English
Germany	member of	United States of America
Stephen Jay Gould	diplomatic relation	United States of America
Nicki Minaj	occupation	French Academy of Sciences
Joseph Conrad	occupation	Spanish
Czech Republic	occupation	United States of America
Russia	diplomatic relation	American Academy of Arts and Sciences
Lenny Kravitz	occupation	International Finance Corporation
Mary-Kate Olsen	instrument	United States of America
Carl Peter Thunberg	member of	United States of America
Stephen Hawking	diplomatic relation	French Academy of Sciences
Lori Lieberman	cause of death	World Trade Organization
Vanessa Williams	instrument	World Trade Organization
Gaspard de Prony	diplomatic relation	International Finance Corporation
Dalida	diplomatic relation	World Trade Organization
Theodore von Kármán	diplomatic relation	Azerbaijan
Wilhelm von Humboldt	diplomatic relation	United States of America
Milan Kundera	diplomatic relation	International Finance Corporation
Luxembourg	diplomatic relation	English
Santiago Ramón y Cajal	record label	children's writer
Friedrich von Raumer	occupation	United States of America
Norman Mailer	occupation	International Development Association
Dmitri Kabalevsky	influenced by	United States of America
Urbain Le Verrier	member of	mathematics
Steven Seagal	member of	Russian Academy of Sciences
Switzerland	occupation	United States of America
United States of America	occupation	historian
Boris Grebenshchikov	country of citizenship	children's writer
Paraguay	occupation	English
Günther Anders	place of birth	National Academy of Sciences
Willow Smith	diplomatic relation	International Telecommunication Union
Anatoly Lunacharsky	member of	Yemen
Lara Fabian	occupation	United States of America
Finland	member of	World Trade Organization
Vladimir Nabokov	cause of death	International Finance Corporation
Karlheinz Stockhausen	genre	symphony
United States of America	languages spoken, written, or signed	Atlantic Records
United States of America	country of citizenship	UNESCO
Guinea	member of	Universal Postal Union
Nelly	occupation	International Development Association
Simone de Beauvoir	occupation	Organization of American States
Tomáš Garrigue Masaryk	diplomatic relation	physics
Italy	diplomatic relation	United States of America
Enzo Jannacci	occupation	Royal Prussian Academy of Sciences
Simon Newcomb	diplomatic relation	United States of America
Albania	occupation	Saint Petersburg Academy of Sciences
Joyce Carol Oates	member of	French Academy of Sciences
Steven Seagal	genre	Academy of Sciences of Turin
Alphonse Daudet	occupation	musical composition
Norman Mailer	occupation	musical composition
United Arab Emirates	religion	Commonwealth of Nations
Holy Roman Empire	languages spoken, written, or signed	United States of America
North Korea	cast member	International Development Association
Jean-Victor Poncelet	diplomatic relation	French
Marlene Dietrich	member of	Academy of Sciences of the USSR
Theodore von Kármán	diplomatic relation	Humboldt University of Berlin
Kid Cudi	diplomatic relation	International Development Association
Sri Lanka	diplomatic relation	English
Manfred Eigen	occupation	Universal Postal Union
Alexis Korner	member of	National Academy of Sciences
Robin Thicke	member of	AFRISTAT
Meat Loaf	occupation	International Finance Corporation
Adolf Erik Nordenskiöld	ethnic group	World Trade Organization
Herbie Hancock	occupation	contemporary R&B
Nat King Cole	occupation	International Finance Corporation
Lucio Dalla	diplomatic relation	National Academy of Sciences
Christopher Hitchens	record label	Fyodor Dostoyevsky
Niger	member of	Asian Development Bank
Georg Forster	languages spoken, written, or signed	International Hydrographic Organization
Romain Rolland	occupation	essayist
Ilya Oleynikov	occupation	Lincean Academy
Bertrand Russell	diplomatic relation	International Development Association
Kenya	occupation	United States of America
William H. Macy	influenced by	United States of America
Miguel de Unamuno	occupation	United States of America
Suzi Quatro	occupation	Göttingen Academy of Sciences
Anatoly Lunacharsky	instrument	Juilliard School
Rudolf Virchow	diplomatic relation	Universal Postal Union
Hugo Grotius	educated at	Italian
Allen Ginsberg	genre	"University of California, Berkeley"
Whitney Houston	member of	Italian
Cuba	member of	Academy of Sciences of the USSR
Suriname	member of	Deryck Whibley
Christopher Hitchens	ethnic group	Phi Beta Kappa Society
United States of America	member of	Canada
Nas	field of work	United States of America
Neil Young	occupation	Group on Earth Observations
Ivan Urgant	member of	World Trade Organization
Vince Neil	instrument	English
Benedetto Croce	country of citizenship	United States of America
Eswatini	occupation	Democratic Party
Michael Penn	occupation	musical composition
Tuvalu	member of	United States of America
Harry Connick Jr.	country of citizenship	dance-pop
Zora Neale Hurston	occupation	United States of America
France	member of	Royal Prussian Academy of Sciences
North Korea	member of	Bavarian Academy of Fine Arts
Winston Churchill	country of citizenship	French
Hulk Hogan	occupation	United States of America
Frédéric Joliot-Curie	languages spoken, written, or signed	Russian Academy of Sciences
Mauritius	occupation	Dante Alighieri
Mozambique	record label	French Academy of Sciences
Kiely Williams	place of birth	United States of America
Alexander Ivanovich Herzen	member of	Democratic Party
Tunisia	diplomatic relation	Barbados
Golo Mann	continent	Democratic Party
Andrea Bocelli	genre	African Development Bank
Melchior de Vogüé	occupation	Austria-Hungary
Sweden	country of citizenship	Bavarian Academy of Sciences and Humanities
Jimmy Fallon	occupation	Warner Bros. Records
Malaysia	record label	English
United States of America	member of	United States of America
Tara Strong	diplomatic relation	United Nations
South Africa	languages spoken, written, or signed	United States of America
Ivan Illich	occupation	music pedagogue
Belgium	country of citizenship	United States of America
Luxembourg	member of	African Union
Gustav Kirchhoff	member of	International Finance Corporation
Morocco	diplomatic relation	United States of America
Sri Lanka	occupation	Treaty on Open Skies
Anna Akhmatova	member of	Russian Academy of Sciences
Mircea Eliade	country of citizenship	Russian Academy of Sciences
Alla Pugacheva	occupation	Treaty on Open Skies
Democratic Republic of the Congo	record label	England
Mali	occupation	International Finance Corporation
Uruguay	occupation	English
Karl Lachmann	instrument	Spanish
Guinea	instrument	Royal Netherlands Academy of Arts and Sciences
Fred Hoyle	occupation	Italian
Drake	diplomatic relation	United States of America
Michael Bublé	occupation	singer-songwriter
William H. Macy	member of	European Space Agency
Mihajlo Pupin	sibling	German
Italy	instrument	Royal Prussian Academy of Sciences
Lowell George	record label	Commonwealth of Nations
Damon Albarn	member of	United Nations
Rabindranath Tagore	diplomatic relation	Georg Wilhelm Friedrich Hegel
Phil Collins	occupation	Group on Earth Observations
Janet Jackson	occupation	United States of America
Marietta Shaginyan	member of	USSR Union of Writers
Switzerland	field of work	English
Frank Wedekind	occupation	United Nations
Barbados	languages spoken, written, or signed	Universal Postal Union
Saint Vincent and the Grenadines	instrument	diarist
Stanislao Cannizzaro	diplomatic relation	Ludwig Maximilian University of Munich
Kingsley Amis	occupation	Caribbean Development Bank
St. Vincent	child	United States of America
Lisa Marie Presley	member of	Polish
Cass Elliot	occupation	International Development Association
Cuba	influenced by	United States of America
Mary Shelley	official language	Père Lachaise Cemetery
"Weird Al" Yankovic	country of citizenship	physics
Henry Kissinger	occupation	African Development Bank
Ivan Andreyevich Krylov	occupation	North Macedonia
August Schleicher	part of	Georg Wilhelm Friedrich Hegel
Comoros	occupation	East Timor
North Macedonia	occupation	Göttingen Academy of Sciences
Camillo Golgi	member of	United Nations
Ludwig Wittgenstein	diplomatic relation	World Trade Organization
Jared Leto	occupation	International Development Association
Omar Sharif	diplomatic relation	Council of Europe
Nicaragua	diplomatic relation	Royal Prussian Academy of Sciences
Rainer Werner Fassbinder	occupation	International Finance Corporation
Alexander von Humboldt	occupation	English
Leopold von Ranke	member of	United States of America
United States of America	diplomatic relation	jazz musician
Sarah McLachlan	member of	Asian Development Bank
Vietnam	occupation	Universal Postal Union
Paul Hindemith	residence	Treaty on Open Skies
Jodie Foster	occupation	Georg Wilhelm Friedrich Hegel
J. R. R. Tolkien	occupation	Royal Society
Alexander R. Todd, Baron Todd	residence	Humboldt University of Berlin
Priscilla Presley	occupation	Democratic Party
Jim Belushi	record label	African Development Bank
Uzbekistan	occupation	Czech Republic
Mircea Eliade	member of	International Development Association
Dave Matthews	influenced by	singer-songwriter
Eritrea	occupation	Ray Bradbury
Tyler, the Creator	member of	United States of America
Vitaly Ginzburg	occupation	Grenada
Lion Feuchtwanger	member of	Australia Group
El Salvador	occupation	Council of Europe
Sting	instrument	Group on Earth Observations
Karlheinz Stockhausen	educated at	AFRISTAT
Svetlana Surganova	genre	United Nations
Mickey Rooney	diplomatic relation	French
Romania	occupation	Bavarian Academy of Sciences and Humanities
Montenegro	influenced by	United States of America
Thomas Henry Huxley	diplomatic relation	Russian Empire
Mel Gibson	occupation	English
Randy Travis	diplomatic relation	contemporary R&B
Azerbaijan	country of citizenship	United States of America
Sudan	occupation	Royal Swedish Academy of Sciences
Yul Brynner	languages spoken, written, or signed	Asian Development Bank
People's Republic of China	instrument	Los Angeles
El Salvador	educated at	North Macedonia
Heinrich Schliemann	member of	Anglicanism
David Clayton-Thomas	continent	A&M Records
Condoleezza Rice	instrument	Søren Kierkegaard
Georgia	occupation	United States of America
Lou Reed	languages spoken, written, or signed	"University of California, Los Angeles"
Stacie Orrico	residence	musical composition
Augustine of Hippo	occupation	science fiction writer
CeeLo Green	instrument	United States of America
Bernard-Henri Lévy	ethnic group	Warner Bros. Records
Jada Pinkett Smith	member of	singer-songwriter
André Gide	instrument	World Trade Organization
Camille Saint-Saëns	occupation	Russian Empire
Levon Helm	member of	Movement Coordination Centre Europe
Count Basie	diplomatic relation	Democratic Party
Italy	diplomatic relation	Organisation internationale de la Francophonie
San Marino	occupation	Arab League
Tonga	residence	Lincean Academy
Paraguay	instrument	European Space Agency
Spain	record label	United States of America
Jackson Browne	occupation	Polish
Comoros	languages spoken, written, or signed	Movement Coordination Centre Europe
William Thomson, 1st Baron Kelvin	genre	satire
Theodore Roosevelt	member of	Royal Society of Edinburgh
Cher	diplomatic relation	International Finance Corporation
Buffy Sainte-Marie	occupation	National Academy of Sciences
Jeff Goldblum	diplomatic relation	Warner Bros. Records
Kuwait	diplomatic relation	North Korea
Miles Davis	country of origin	English
Hungary	occupation	International Telecommunication Union
Georges Cuvier	influenced by	United States of America
James Taylor	diplomatic relation	French
Massimo Bontempelli	occupation	Caribbean Development Bank
Trent Reznor	member of	Visa Waiver Program
Tunisia	diplomatic relation	International Development Association
Tonga	occupation	contemporary R&B
Richard Wagner	place of death	United States of America
Bruce Springsteen	occupation	Republican Party
Dominican Republic	occupation	Venezuela
Guatemala	member of	Academy of Sciences of Turin
Joseph E. Stiglitz	occupation	Movement Coordination Centre Europe
Ivan Goncharov	diplomatic relation	Göttingen Academy of Sciences
František Palacký	instrument	geographer
South Korea	occupation	African Union
Democratic Republic of the Congo	record label	Serbia
New Zealand	occupation	French
Irving Berlin	diplomatic relation	World Trade Organization
Germany	member of	Organisation internationale de la Francophonie
Luis Alberto Spinetta	diplomatic relation	Grenada
Nigeria	part of	French
Hungary	diplomatic relation	United States of America
William Butler Yeats	movement	children's writer
Belarus	occupation	English
Willie Nelson	part of	German
Karl Valentin	instrument	singer-songwriter
Friedrich Wilhelm Joseph Schelling	occupation	Ashkenazi Jews
Slavoj Žižek	occupation	Universal Postal Union
India	genre	English
Eric Idle	occupation	Serbian Academy of Sciences and Arts
Samuel Beckett	diplomatic relation	United States of America
François-René de Chateaubriand	residence	Lebanon
Janis Joplin	languages spoken, written, or signed	Universal Postal Union
Jerry Garcia	diplomatic relation	International Development Association
William Butler Yeats	country of citizenship	African Americans
Neil Gaiman	languages spoken, written, or signed	Council of Europe
Indonesia	occupation	Group on Earth Observations
Zambia	religion	English
Vincent Gallo	languages spoken, written, or signed	International Development Association
Eduard Suess	member of	Middle East
Russia	occupation	International Bank for Reconstruction and Development
Peggy Lee	occupation	singer-songwriter
Debbie Gibson	occupation	United States of America
United Arab Emirates	member of	United States of America
Yoram Kaniuk	occupation	Karl Marx
Angola	occupation	Council of Europe
Jerry Reed	instrument	musical composition
Jan Hammer	instrument	United States of America
Søren Kierkegaard	diplomatic relation	Republican Party
Galileo Galilei	genre	Arab Monetary Fund
MC Hammer	field of work	Universal Postal Union
Mali	occupation	United States of America
Winston Churchill	member of	United States of America
United States of America	diplomatic relation	Saint Petersburg
Tina Arena	country of citizenship	United States of America
United States of America	diplomatic relation	author
Argentina	member of	Antigua and Barbuda
François Arago	occupation	United States of America
Ghana	member of	Bavarian Academy of Fine Arts
Joe Walsh	country of citizenship	National Academy of Sciences
Michael Nesmith	member of	United Arab Emirates
Roman Jakobson	diplomatic relation	European Space Agency
Israel	sibling	Universal Postal Union
Justin Timberlake	diplomatic relation	Group on Earth Observations
Czech Republic	member of	United States of America
Max Weber	occupation	Spanish
Tom Hanks	occupation	musical composition
Charlie Rich	occupation	United States of America
North Korea	diplomatic relation	Republican Party
Paraguay	occupation	German
Graham Parker	residence	Bavarian Academy of Fine Arts
Roger Waters	record label	United States of America
Wole Soyinka	diplomatic relation	Kingdom of Prussia
Cat Stevens	member of	Southern African Development Community
Jada Pinkett Smith	occupation	African Union
South Africa	member of	Malawi
Bangladesh	member of	World Trade Organization
David Foster	residence	African Development Bank
Australia	diplomatic relation	American Academy of Arts and Sciences
Zoë Kravitz	member of	European Payments Union
Anatoly Krupnov	diplomatic relation	African Development Bank
North Korea	genre	Russian
Ruslana	employer	Democratic Party
Yul Brynner	diplomatic relation	International Development Association
Paul Langevin	diplomatic relation	Russian Academy of Sciences
Democratic Republic of the Congo	official language	United Nations
Rita Lee	occupation	Hebrew
Saudi Arabia	influenced by	National Academy of Sciences
Hong Kong	languages spoken, written, or signed	United Nations
James Cameron	member of	Polish
Søren Kierkegaard	member of	Hebrew
Frédéric Joliot-Curie	occupation	diarist
Saudi Arabia	occupation	German
Emilie Autumn	influenced by	Royal Society of Literature
Robin Thicke	member of	Interpol
Iran	diplomatic relation	Universal Postal Union
André Gide	member of	African Americans
Nikolay Semyonov	member of	South Korea
Gabriel García Márquez	member of	Royal Society
Peter Kropotkin	diplomatic relation	Decca
Denmark	instrument	English
Ernest Hemingway	residence	contemporary R&B
Omar Sharif	languages spoken, written, or signed	Commonwealth of Nations
Viggo Mortensen	occupation	Vladimir Nabokov
Albert Einstein	diplomatic relation	United States of America
Nicaragua	medical condition	United Nations
Valeriya Novodvorskaya	occupation	Saudi Arabia
United Kingdom	field of work	International Finance Corporation
Alexander Alexandrovich Fadeyev	religion	Russian Academy of Sciences
Australia	record label	International Finance Corporation
Gaspard de Prony	ethnic group	United States of America
Satyajit Ray	occupation	Judd Apatow
New Zealand	occupation	Peru
William Blake	member of	children's writer
Philippines	diplomatic relation	Royal Prussian Academy of Sciences
Giovanni Schiaparelli	member of	physics
John Cale	occupation	singer-songwriter
Algeria	country of citizenship	United States of America
Gottfried Wilhelm Leibniz	occupation	State of Palestine
Norway	employer	English
will.i.am	occupation	singer-songwriter
Phil Harris	occupation	United States of America
Fred Hoyle	member of	United Arab Emirates
Shaquille O'Neal	diplomatic relation	Humboldt University of Berlin
Edmund Wilson	part of	Russian Academy of Sciences
Vanuatu	member of	Herman Melville
Lionel Hampton	genre	World Trade Organization
Kid Rock	occupation	musical composition
Alexander Emanuel Agassiz	occupation	Saudi Arabia
São Tomé and Príncipe	residence	non-fiction writer
Walker Percy	member of	United Nations
Central African Republic	occupation	Schengen Area
Joan Rivers	religion	Nuclear Suppliers Group
Janis Ian	country of citizenship	Southern African Development Community
Charles Bukowski	occupation	Russian Empire
Vanessa Williams	diplomatic relation	United Nations
Canada	occupation	Academy of Sciences of Turin
Georg Forster	genre	United States of America
Singapore	diplomatic relation	United States of America
H. P. Lovecraft	record label	African Americans
Saudi Arabia	genre	Missile Technology Control Regime
United States of America	diplomatic relation	Moscow
Brian Wilson	occupation	Council of Europe
Tinashe	member of	Southern African Development Community
Drake	record label	Democratic Party
Mýa	influenced by	United States of America
Alexander von Humboldt	member of	"University of California, Los Angeles"
Kingdom of the Netherlands	instrument	music pedagogue
Barthold Georg Niebuhr	occupation	musicologist
Avicenna	member of	International Energy Agency
will.i.am	diplomatic relation	Turkmenistan
Tom Hanks	occupation	Russian Soviet Federative Socialist Republic
Mario Vargas Llosa	diplomatic relation	Royal Society
AJ Michalka	influenced by	Missile Technology Control Regime
Siméon Denis Poisson	occupation	Interpol
Ray Bradbury	genre	German Academy of Sciences at Berlin
Allan Sherman	diplomatic relation	Elizabeth II
Gilles Deleuze	member of	American Philosophical Society
Vietnam	member of	Academy of Sciences of the USSR
Corbin Bleu	country of citizenship	International Development Association
Rodion Shchedrin	diplomatic relation	West Africa
Afrika Bambaataa	occupation	singer-songwriter
Jerry Reed	record label	Democratic Party
Los Angeles	occupation	children's writer
Ricky Martin	occupation	National Academy of Sciences
Immanuel Kant	record label	Italian
Hector Berlioz	country	musical composition
Gretchen Wilson	occupation	Spanish
Augusto Righi	diplomatic relation	Washington, D.C.
Boris Vian	diplomatic relation	French Academy of Sciences
Mario Praz	influenced by	United States of America
J. M. Coetzee	occupation	film editor
Bulgaria	occupation	Russian Academy of Sciences
Madagascar	place of birth	North Korea
Fred Hoyle	occupation	Visa Waiver Program
Rodion Shchedrin	place of death	science fiction
Kenny Rogers	country of citizenship	Royal Swedish Academy of Sciences
Lea Salonga	occupation	singer-songwriter
Monaco	diplomatic relation	Royal Society
Hugo Grotius	occupation	Royal Society
Veniamin Smekhov	occupation	United States of America
Norway	occupation	World Trade Organization
Montenegro	diplomatic relation	contemporary R&B
Judaism	instrument	Pontifical Academy of Sciences
Nikolai Gogol	occupation	philosophy
Vladislav Krapivin	genre	Ashkenazi Jews
Mircea Eliade	country of citizenship	Kingdom of Prussia
Woody Allen	part of	Commonwealth of Nations
Afrika Bambaataa	member of	African Union
Woody Allen	occupation	UNESCO
Gambia	diplomatic relation	NATO
Waylon Jennings	occupation	Russian Academy of Sciences
Albrecht von Haller	place of birth	singer-songwriter
Graham Parker	educated at	American English
Hungary	genre	International Finance Corporation
Indonesia	member of	United States of America
Yemen	diplomatic relation	West Africa
Gustav Kirchhoff	country of citizenship	Spanish
Zdeněk Nejedlý	occupation	David Hume
Felix Mendelssohn	official language	United Nations
United Kingdom	member of	East Africa
Kelly Clarkson	member of	United States of America
Arnold Schoenberg	instrument	AFRISTAT
Spain	diplomatic relation	United States of America
G. K. Chesterton	occupation	Royal Society
Ján Kollár	member of	musical composition
Dolly Parton	genre	Royal Prussian Academy of Sciences
Levon Helm	member of	École Polytechnique
Lauren Bacall	member of	École Polytechnique
Paul G. Allen	occupation	music pedagogue
Faith Evans	occupation	Soviet Union
Miguel de Cervantes	occupation	singer-songwriter
Ingrid Michaelson	member of	United Nations
Ukraine	country of citizenship	Universal Postal Union
David Mamet	member of	French people
George Henschel	occupation	singer-songwriter
Mexico	diplomatic relation	English
Leonardo da Vinci	diplomatic relation	contemporary R&B
Luis Alberto Spinetta	occupation	Australia Group
Kurt Weill	member of	Royal Society of Edinburgh
Robert Downey, Jr.	member of	Grenada
Germany	member of	World Trade Organization
Marlon Jackson	occupation	Polydor Records
Brazil	member of	French
Andrey Korotayev	member of	Latin America
Heinrich Schliemann	occupation	singer-songwriter
Jeff Goldblum	occupation	Royal Society
Joe Satriani	diplomatic relation	European Payments Union
Ève Curie	member of	Russian Academy of Sciences
György Lukács	occupation	English people
William Thomson, 1st Baron Kelvin	diplomatic relation	short story
Debbie Gibson	diplomatic relation	singer-songwriter
Herman Francis Mark	languages spoken, written, or signed	World Trade Organization
Portugal	member of	Missile Technology Control Regime
Bryan Ferry	country of citizenship	International Development Association
Slovenia	instrument	United Kingdom of Great Britain and Ireland
David A. Stewart	occupation	singer-songwriter
Toni Morrison	diplomatic relation	Alliance of Small Island States
August Schleicher	diplomatic relation	Movement Coordination Centre Europe
Sting	languages spoken, written, or signed	United States of America
Gabriel Marcel	country	Asian Development Bank
Maya Angelou	diplomatic relation	National Academy of Sciences
Joseph Louis Gay-Lussac	member of	Egypt
Alyson Michalka	languages spoken, written, or signed	Académie Française
James Blake	country of citizenship	Hungarian Academy of Sciences
John Denver	residence	Treaty on Open Skies
Andorra	occupation	European Union
Serge Gainsbourg	country of citizenship	Republican Party
Vienna	occupation	Georgia
Alanis Morissette	diplomatic relation	NATO
Mylène Farmer	genre	children's writer
Roger Daltrey	occupation	philosophy
Luis Alberto Spinetta	member of	Saudi Arabia
Max Frisch	diplomatic relation	Père Lachaise Cemetery
Romania	diplomatic relation	French
Taiwan	field of work	English
Fritz Haber	diplomatic relation	singer-songwriter
Julio Iglesias	member of	Hebrew
Anatole Abragam	occupation	singer-songwriter
Glen Campbell	genre	Universal Postal Union
Taiwan	member of	International Finance Corporation
Buckminster Fuller	occupation	Southern African Development Community
Serbia	occupation	English
Jan Evangelista Purkyně	occupation	Eurocontrol
Cape Verde	diplomatic relation	Yemen
Soulja Boy	country of citizenship	Republican Party
Sri Lanka	diplomatic relation	Bulgaria
Sergei Korolev	member of	Humboldt University of Berlin
Lance Bass	genre	Humboldt University of Berlin
Noël Coward	place of death	United Kingdom
Wole Soyinka	member of	science fiction
Sheldon Lee Glashow	place of birth	United States of America
T. S. Eliot	residence	jazz musician
William Blake	languages spoken, written, or signed	Russian Academy of Sciences
Djibouti	occupation	United States of America
Theodor Nöldeke	occupation	United Nations
Darius Milhaud	instrument	"University of California, Berkeley"
Ghana	member of	Royal Society of Literature
Robin Gibb	occupation	Czech
Malaysia	ethnic group	French
Bella Thorne	occupation	contemporary R&B
Elfriede Jelinek	member of	singer-songwriter
Brazil	member of	African Development Bank
Tom Wolfe	occupation	children's writer
Suzi Quatro	diplomatic relation	music pedagogue
Christina Aguilera	educated at	United States of America
Pyotr Ilyich Tchaikovsky	diplomatic relation	Syria
Ivan Urgant	genre	musical composition
Philip Glass	occupation	International Development Association
Mexico	member of	Organisation of Islamic Cooperation
Joss Stone	diplomatic relation	National Academy of Sciences
Sun Ra	occupation	International Finance Corporation
Germany	member of	German Academy of Sciences Leopoldina
Ed Sheeran	occupation	singer-songwriter
Belgium	occupation	English
Noël Coward	occupation	Eurocontrol
Gustavo Cerati	occupation	International Development Association
Philippines	genre	United States of America
Bette Midler	country of citizenship	African Americans
Mark Linkous	occupation	Republic of Cyprus
Paul Auster	educated at	Movement Coordination Centre Europe
Hans Christian Ørsted	member of	UNESCO
Milla Jovovich	diplomatic relation	São Tomé and Príncipe
Ben Stiller	place of death	Hungarian
Benoit Mandelbrot	diplomatic relation	Iceland
A. R. Rahman	genre	Jordan
Bill Monroe	occupation	singer-songwriter
Christina Milian	diplomatic relation	Humboldt University of Berlin
Ingeborg Bachmann	genre	USSR Union of Writers
Tomáš Garrigue Masaryk	record label	Nigeria
Romania	occupation	Caribbean Development Bank
Veniamin Smekhov	diplomatic relation	Interscope Records
Arthur Schopenhauer	occupation	singer-songwriter
Faith Evans	occupation	Hungarian Academy of Sciences
David Brewster	place of birth	Commonwealth of Nations
Mika	occupation	contemporary R&B
Stephen King	languages spoken, written, or signed	United States of America
Keith Richards	employer	European Space Agency
John Cameron Mitchell	diplomatic relation	Phi Beta Kappa Society
Günter Grass	record label	Commonwealth of Nations
Satyajit Ray	occupation	Hollywood Records
Israel	occupation	United States of America
Chile	diplomatic relation	Italian
Jerry Lewis	diplomatic relation	Royal Prussian Academy of Sciences
Julio Iglesias	record label	Commonwealth of Nations
Togo	occupation	United States of America
Violetta Villas	member of	children's writer
Saint Kitts and Nevis	occupation	Sony Music
Eswatini	occupation	German Empire
Gloria Estefan	occupation	"University of California, Berkeley"
Sudan	genre	Russian Academy of Sciences
Peter Debye	occupation	Asian Development Bank
Qatar	member of	Russian Soviet Federative Socialist Republic
Jean Gaston Darboux	instrument	Kuwait
Tonga	member of	Holy See
Gabon	diplomatic relation	Katy Perry
Kenny Rogers	occupation	Serbian Academy of Sciences and Arts
Edmund Wilson	diplomatic relation	Democratic Party
Janis Joplin	official language	United States of America
South Korea	member of	Holy See
Giorgio Gaber	diplomatic relation	German Academy of Sciences at Berlin
Peter Lorre	member of	singer-songwriter
Roy Orbison	place of death	Portuguese
Ronny Cox	instrument	singer-songwriter
Evelyn Waugh	occupation	Democratic Party
Isaac Bashevis Singer	languages spoken, written, or signed	mandolinist
Canada	country of citizenship	Deutsche Akademie für Sprache und Dichtung
Myles Kennedy	languages spoken, written, or signed	African Union
Qatar	occupation	United States of America
Sri Lanka	occupation	African Union
Julian Barnes	country of citizenship	singer-songwriter
Roy Clark	religion	Elizabeth II
Sky Ferreira	record label	Humboldt University of Berlin
Finland	country of citizenship	French Academy of Sciences
Bosnia and Herzegovina	country of citizenship	Royal Society
John Cassavetes	member of	librettist
Wernher von Braun	occupation	OHADA
People's Republic of China	country of citizenship	poet
Taiwan	member of	International Finance Corporation
Paulo Coelho	member of	Novodevichy Cemetery
Argentina	religion	German
Japan	genre	Saint Petersburg Academy of Sciences
Heinrich Wilhelm Olbers	occupation	children's writer
Samoa	languages spoken, written, or signed	United States of America
Gambia	occupation	French people
John Cameron Mitchell	country of citizenship	South Africa
United States of America	occupation	Moscow
Paul McCartney	occupation	children's writer
Kevin Jonas	member of	Missile Technology Control Regime
Augustin-Louis Cauchy	member of	psychedelic rock
Dave Matthews	member of	African Americans
Kuwait	languages spoken, written, or signed	United States of America
Joumana Haddad	country of citizenship	contemporary R&B
Spain	member of	German Academy of Sciences Leopoldina
Adriano Celentano	member of	Holy See
Leszek Kołakowski	occupation	Decca
Tyler, the Creator	member of	singer-songwriter
United States of America	genre	translator
Aleksandr Solzhenitsyn	diplomatic relation	Soviet Union
Poland	place of burial	Saint Petersburg Academy of Sciences
Rwanda	instrument	Russian Academy of Sciences
Hungary	member of	United States of America
Dmitry Glukhovsky	languages spoken, written, or signed	executive producer
Hannes Alfvén	diplomatic relation	Phi Beta Kappa Society
Serbia	genre	Universal Postal Union
John Maynard Keynes	diplomatic relation	African Development Bank
Stanisław Lem	member of	Fyodor Dostoyevsky
Elizabeth II	diplomatic relation	musicologist
Cambodia	religion	Hungarian Academy of Sciences
Ludacris	occupation	Interscope Records
Egypt	occupation	Russian Academy of Sciences
Yul Brynner	languages spoken, written, or signed	African Union
Republic Records	member of	children's writer
Gaspard de Prony	member of	singer-songwriter
William Morris	member of	Russian Empire
Morgan Freeman	occupation	Georg Wilhelm Friedrich Hegel
Michael Jackson	instrument	French
Stanislao Cannizzaro	occupation	United Nations
Trent Reznor	diplomatic relation	singer-songwriter
A&M Records	instrument	Royal Society of Edinburgh
William Blake	occupation	UNESCO
Saint Lucia	occupation	United States of America
Denmark	diplomatic relation	French
Sir George Stokes, 1st Baronet	country of citizenship	Soviet Union
Ulf Ekberg	record label	musical composition
Iceland	member of	Cape Verde
Andrei Konchalovsky	member of	Columbia Records
Barbados	influenced by	Visa Waiver Program
United States of America	occupation	voice actor
Amos Oz	occupation	20th century
Armenia	educated at	Eurocontrol
Yoko Ono	cause of death	Asian Development Bank
Robert Downey, Jr.	member of	Joseph Conrad
Pavel Jozef Šafárik	occupation	singer-songwriter
New Zealand	languages spoken, written, or signed	North Korea
Wilhelm Blaschke	country of citizenship	United States of America
Joseph Heller	member of	musical composition
Winston Churchill	member of	Royal Society of Edinburgh
United States of America	genre	Ireland
Euclides da Cunha	member of	United States of America
Czech Republic	languages spoken, written, or signed	International Finance Corporation
Montenegro	religion	Commonwealth of Nations
Swizz Beatz	languages spoken, written, or signed	State of Palestine
Lena Meyer-Landrut	occupation	university teacher
Franco Battiato	diplomatic relation	Taiwan
Mauritius	occupation	Lincean Academy
Leon Trotsky	occupation	Russian Empire
Wang Leehom	ethnic group	International Development Association
Clint Eastwood	occupation	Organisation of Islamic Cooperation
W. H. Auden	influenced by	Nigeria
J. Rodolfo Wilcock	influenced by	A&M Records
Norway	occupation	Russian Academy of Sciences
Lev Gumilyov	diplomatic relation	International Energy Agency
Czech Republic	member of	French
Saint Kitts and Nevis	educated at	Poland
Jean Yanne	occupation	French people
Isaac Bashevis Singer	occupation	Belize
Jennette McCurdy	occupation	Franz Kafka
Malaysia	member of	Russian
Albert Szent-Györgyi	ethnic group	University of Göttingen
Grenada	field of work	Interscope Records
Steve Carell	occupation	heart failure
A. R. Rahman	diplomatic relation	United Kingdom
David Walliams	occupation	Dante Alighieri
People's Republic of China	diplomatic relation	journalist
Felix Klein	member of	Papua New Guinea
Gary Becker	country of citizenship	Nuclear Suppliers Group
Joseph Louis Gay-Lussac	country of citizenship	Romania
Alla Pugacheva	diplomatic relation	Visa Waiver Program
John Cameron Mitchell	diplomatic relation	American Philosophical Society
San Marino	diplomatic relation	Czech Republic
Édouard René de Laboulaye	record label	Columbia Records
Kate Voegele	diplomatic relation	librettist
Roger Penrose	languages spoken, written, or signed	musical composition
Qatar	occupation	Djibouti
Syria	occupation	Pontifical Academy of Sciences
Romania	influenced by	International Development Association
Brazil	member of	Asian Development Bank
Ivory Coast	occupation	German Academy of Sciences at Berlin
Iceland	occupation	National Academy of Sciences
Thomas Anders	diplomatic relation	contemporary R&B
North Macedonia	diplomatic relation	Anglicanism
Jean Yanne	occupation	children's writer
W.E.B. Du Bois	languages spoken, written, or signed	New York City
Russia	member of	Royal Swedish Academy of Sciences
Nikolay Semyonov	diplomatic relation	Sri Lanka
Jean-Antoine-Nicolas de Caritat de Condorcet	religion	Greece
František Palacký	instrument	Kazakhstan
United Kingdom	occupation	United States of America
Joe Jackson	genre	French
Keren Ann	influenced by	African Development Bank
United States of America	occupation	essayist
Celeste Buckingham	occupation	International Hydrographic Organization
Julie Driscoll	diplomatic relation	Novodevichy Cemetery
Nigeria	languages spoken, written, or signed	United States of America
Sheryl Crow	occupation	Visa Waiver Program
Taraneh Javanbakht	country of citizenship	Mikhail Bakunin
Cape Verde	spouse	Interpol
Marshall Islands	occupation	Interscope Records
Judd Apatow	occupation	Interpol
James Maslow	occupation	New Zealand
Joan Baez	diplomatic relation	Caribbean Development Bank
Canada	diplomatic relation	United Kingdom of Great Britain and Ireland
Stanislao Cannizzaro	diplomatic relation	agnosticism
Severo Ochoa	country of citizenship	Asian Development Bank
Vitamin C	country of citizenship	Warner Bros. Records
Iran	diplomatic relation	musical composition
Damon Albarn	member of	United States of America
North Korea	genre	Nuclear Suppliers Group
Buckethead	member of	Spanish
Andrey Korotayev	place of birth	African Americans
Barry Gibb	member of	Lincean Academy
k.d. lang	educated at	South Korea
Katharine McPhee	occupation	United Nations
Uruguay	member of	African Union
Vanessa Hudgens	occupation	singer-songwriter
Fritz Haber	occupation	singer-songwriter
Trey Parker	educated at	Spanish
Aleksey Nikolayevich Tolstoy	cast member	Western
Alberto Manguel	diplomatic relation	Warner Bros. Records
Belize	diplomatic relation	Russian Academy of Sciences
Douglas Fairbanks	occupation	singer-songwriter
Keren Ann	genre	Russian Empire
Somalia	diplomatic relation	Schengen Area
India	diplomatic relation	Council of Europe
Paris Hilton	member of	Elizabeth II
Colombia	country of citizenship	Latin
Samuel P. Huntington	diplomatic relation	Humboldt University of Berlin
Dianna Agron	occupation	singer-songwriter
François-René de Chateaubriand	residence	Malaysia
Egypt	occupation	Missile Technology Control Regime
Charles Babbage	occupation	French people
Alla Pugacheva	occupation	African Development Bank
Vladimir Vysotsky	occupation	Jean-Jacques Rousseau
Michael Penn	place of death	singer-songwriter
George Henschel	instrument	Royal Society
Deryck Whibley	residence	literary realism
Iraq	occupation	singer-songwriter
Charlie Rich	instrument	musical composition
Tex Ritter	instrument	Asian Development Bank
People's Republic of China	place of birth	university teacher
Chris Rea	occupation	Asian Development Bank
United States of America	diplomatic relation	Italy
Don DeLillo	occupation	American Philosophical Society
Barbados	languages spoken, written, or signed	Russian Academy of Sciences
Vladimir Lenin	diplomatic relation	International Finance Corporation
Australia	occupation	peace activist
United States of America	member of	professor
Haiti	occupation	Bosnia and Herzegovina
Jennette McCurdy	diplomatic relation	renal insufficiency
Theodor Mommsen	diplomatic relation	Turkey
Jennifer Hudson	religion	Universal Postal Union
Saint Kitts and Nevis	country of citizenship	Taiwan
G. K. Chesterton	educated at	Rwanda
Akon	occupation	African Americans
Brunei	occupation	North Korea
Diana Ross	member of	Spanish
Anastacia	occupation	German
Michel Houellebecq	diplomatic relation	Emmanuel Swedenborg
Italy	member of	United States of America
Andrei Tarkovsky	instrument	Göttingen Academy of Sciences
John Turturro	occupation	Paraguay
Estonia	occupation	Treaty on Open Skies
Guinea	instrument	National Academy of Sciences
Kurt Cobain	occupation	Soviet Union
Chris Martin	diplomatic relation	Democratic Party
People's Republic of China	occupation	politician
Amr Diab	diplomatic relation	International Energy Agency
Slash	occupation	Commonwealth of Nations
Swizz Beatz	diplomatic relation	Spanish
August Wilhelm Schlegel	diplomatic relation	Commonwealth of Nations
Mongolia	country of citizenship	Republican Party
W.E.B. Du Bois	occupation	Bulgaria
North Macedonia	occupation	Royal Society
Joseph Fourier	occupation	European Space Agency
Yevgeny Yevtushenko	diplomatic relation	Cuba
Jordan	diplomatic relation	Academy of Arts, Berlin
Djibouti	member of	UNESCO
Jordin Sparks	official language	Lincean Academy
Alberto Manguel	occupation	UNESCO
Rudolf Christoph Eucken	member of	NATO
John Denver	occupation	French
Maya Angelou	occupation	Soviet Union
Nigeria	member of	European Union
Robin Williams	member of	singer-songwriter
Hans Christian Ørsted	genre	University of Bonn
Michel Houellebecq	diplomatic relation	Saudi Arabia
George Soros	occupation	musical composition
François Guizot	diplomatic relation	Sri Lanka
Albert Szent-Györgyi	occupation	singer-songwriter
Gambia	occupation	Barbados
Stanisław Lem	occupation	African Development Bank
Milva	diplomatic relation	Hungarian Academy of Sciences
Yeshayahu Leibowitz	member of	Columbia Records
Simon Newcomb	diplomatic relation	East Africa
São Tomé and Príncipe	country of citizenship	rock and roll
Faith Evans	ethnic group	Asia-Pacific Economic Cooperation
John Muir	country	Spanish
Taiwan	member of	German
Uruguay	diplomatic relation	Pakistan
Iraq	occupation	Warner Bros. Records
Marlon Jackson	spouse	Eurocontrol
Mike Shinoda	member of	OHADA
Joe Cocker	diplomatic relation	Humboldt University of Berlin
Robert Musil	diplomatic relation	Nuclear Suppliers Group
Thailand	diplomatic relation	Russian Academy of Sciences
André Gide	instrument	Humboldt University of Berlin
Usher	genre	UNESCO
Arnold Schwarzenegger	occupation	Warner Bros. Records
Andrei Konchalovsky	member of	African Americans
Guy de Maupassant	record label	singer-songwriter
Robin Gibb	languages spoken, written, or signed	Humboldt University of Berlin
La Toya Jackson	employer	Robert Louis Stevenson
Henri Poincaré	occupation	Royal Society
Poland	diplomatic relation	Spanish
France	languages spoken, written, or signed	Russian
Ray Lankester	genre	Royal Society
Milla Jovovich	religion	theater director
Albania	occupation	United Nations
Indonesia	instrument	United Nations
Ernst Mayr	diplomatic relation	Saudi Arabia
Max Brod	member of	literary critic
Liberia	occupation	music pedagogue
August Wilhelm Schlegel	member of	Humboldt University of Berlin
Zambia	member of	Russian Soviet Federative Socialist Republic
Czechoslovakia	influenced by	singer-songwriter
Jada Pinkett Smith	occupation	Virgin Records
Johann Wolfgang von Goethe	diplomatic relation	librettist
Boris Grebenshchikov	languages spoken, written, or signed	Columbia Records
Ivan Goncharov	diplomatic relation	musical composition
Joss Whedon	diplomatic relation	librettist
Jean Gaston Darboux	occupation	singer-songwriter
Daniel Lanois	employer	University of Göttingen
Kingsley Amis	occupation	children's writer
Noël Coward	diplomatic relation	Academy of Useful Science
Adam Sandler	member of	Royal Society
Hungary	occupation	United States of America
Josephine Baker	occupation	myocardial infarction
Greece	occupation	Organisation of Islamic Cooperation
Czesław Miłosz	residence	Holy See
Friedrich Nietzsche	diplomatic relation	Saudi Arabia
Ludwig Geiger	record label	Asia-Pacific Economic Cooperation
Sonny Bono	record label	New York City
Philip Glass	diplomatic relation	singer-songwriter
Venezuela	country of citizenship	United Nations
Valentin Kataev	instrument	Père Lachaise Cemetery
Eric Burdon	occupation	heart failure
Mauritania	occupation	Janet Jackson
Jeff Bridges	member of	Warner Bros. Records
Al-Biruni	diplomatic relation	singer-songwriter
United Arab Emirates	diplomatic relation	Humboldt University of Berlin
Mauritius	head of state	Spanish
Brian Wilson	languages spoken, written, or signed	science fiction writer
Arthur Schopenhauer	occupation	United States of America
United States of America	country of citizenship	jazz musician
Joseph-Louis Lagrange	member of	Vietnam
San Marino	member of	Zimbabwe
Seth MacFarlane	occupation	science fiction writer
Johann Christian Poggendorff	religion	African Union
Galileo Galilei	record label	Ludwig Maximilian University of Munich
Argentina	occupation	United Nations
T. S. Eliot	occupation	opera
Ilya Ehrenburg	member of	African Americans
Haiti	country of citizenship	Russian Academy of Sciences
Mike Myers	occupation	Arab Monetary Fund
Mikhail Bulgakov	languages spoken, written, or signed	United States of America
Paul Hindemith	diplomatic relation	contemporary R&B
The Compleat Beatles	member of	Golo Mann
Shen Kuo	genre	Royal Society
Alexey Vorobyov	occupation	Paraguay
State of Palestine	diplomatic relation	Taiwan
Samuel Johnson	member of	Spanish
Japan	country of citizenship	Robert Graves
Ecuador	occupation	Republican Party
Tunisia	place of death	Democratic Party
Joseph E. Stiglitz	occupation	Royal Society
Thomas Jefferson	occupation	State of Palestine
Mick Jagger	member of	singer-songwriter
Mexico	member of	United States of America
Liberia	country of citizenship	Pakistan
Sierra Leone	employer	Jamaica
Chile	member of	Academy of Sciences of the USSR
Angelina Jolie	occupation	singer-songwriter
Boris Grebenshchikov	genre	mandolin
Debby Ryan	member of	Council of Europe
Max Born	diplomatic relation	United Nations
Senegal	occupation	German
Mae West	diplomatic relation	New York City
Johnny Hallyday	occupation	Motown
Nat King Cole	place of burial	singer-songwriter
Czech Republic	occupation	Papua New Guinea
Federated States of Micronesia	cast member	singer-songwriter
Charlie Chaplin	occupation	Royal Society of Edinburgh
Kosovo	religion	Soviet Union
Tajikistan	occupation	Australia Group
New Zealand	member of	Benin
Elfriede Jelinek	instrument	powest
Liechtenstein	country of citizenship	Columbia Records
Fyodor Dostoyevsky	continent	film score composer
Denis Johnson	diplomatic relation	United States of America
Tamara Bunke	occupation	United Nations
Snoop Dogg	languages spoken, written, or signed	French people
Bertrand Russell	member of	Movement Coordination Centre Europe
Equatorial Guinea	instrument	United States of America
Vince Gill	occupation	Pontifical Academy of Sciences
Max Born	genre	Group on Earth Observations
Sri Lanka	occupation	contemporary R&B
John William Strutt, 3rd Baron Rayleigh	country of citizenship	Columbia Records
Woody Allen	occupation	AFRISTAT
Albert Einstein	head of state	Missile Technology Control Regime
People's Republic of China	occupation	film director
Eric Idle	diplomatic relation	Interscope Records
Belarus	diplomatic relation	Montparnasse Cemetery
E. T. A. Hoffmann	educated at	American Jews
Bahamas	member of	Ethiopia
Trinidad and Tobago	child	cancer
Argentina	diplomatic relation	San Marino
Nicki Minaj	influenced by	Soviet Union
Gottfried Wilhelm Leibniz	member of	Haiti
Jacobus Henricus van 't Hoff	occupation	Spain
Albert Einstein	occupation	Warner Bros. Records
Roy Orbison	instrument	South Korea
Joan Rivers	occupation	Columbia Records
Taiwan	country of citizenship	Accademia Nazionale delle Scienze detta dei XL
Serbia	member of	G20
South Korea	country of citizenship	Emma Goldman
