Hamburg	member of	Agency for the Prohibition of Nuclear Weapons in Latin America and the Caribbean
Papua New Guinea	member of	Organisation for the Prohibition of Chemical Weapons
Russian Soviet Federative Socialist Republic	occupation	"African, Caribbean and Pacific Group of States"
Bobby Brown	member of	Organisation for the Prohibition of Chemical Weapons
Mohandas Karamchand Gandhi	member of	International Centre for Settlement of Investment Disputes
Hamburg	occupation	Organization for Security and Co-operation in Europe
Douglas Adams	religion	Organisation for the Prohibition of Chemical Weapons
Timbaland	country of citizenship	International Bank for Reconstruction and Development
Theo van Gogh	occupation	Organization for Security and Co-operation in Europe
Vladimir Obruchev	occupation	Organisation for the Prohibition of Chemical Weapons
Lucy Liu	occupation	Organisation for the Prohibition of Chemical Weapons
Cyndi Lauper	occupation	Organisation for the Prohibition of Chemical Weapons
Ronny Cox	occupation	"African, Caribbean and Pacific Group of States"
Burundi	member of	Organisation for the Prohibition of Chemical Weapons
Vladimir Vysotsky	occupation	"African, Caribbean and Pacific Group of States"
Mary Pickford	occupation	"African, Caribbean and Pacific Group of States"
Ernst Curtius	educated at	International Centre for Settlement of Investment Disputes
Herbie Hancock	member of	International Bank for Reconstruction and Development
Wolfhart Pannenberg	occupation	Organisation for the Prohibition of Chemical Weapons
David Mitchell	member of	Organisation for the Prohibition of Chemical Weapons
Pierre-Joseph Proudhon	member of	International Centre for Settlement of Investment Disputes
Ted Nugent	diplomatic relation	Organisation for the Prohibition of Chemical Weapons
Mstislav Keldysh	member of	Multilateral Investment Guarantee Agency
Vince Gill	influenced by	International Centre for Settlement of Investment Disputes
Jive	occupation	International Bank for Reconstruction and Development
Ronald Reagan	occupation	Organisation for the Prohibition of Chemical Weapons
Eddie Money	member of	Multilateral Investment Guarantee Agency
Wilhelm Grimm	occupation	Multilateral Investment Guarantee Agency
John Desmond Bernal	occupation	Organisation for the Prohibition of Chemical Weapons
Belize	diplomatic relation	Organisation for the Prohibition of Chemical Weapons
Rita Lee	occupation	"African, Caribbean and Pacific Group of States"
Mongolia	movement	Organisation for the Prohibition of Chemical Weapons
Guatemala	diplomatic relation	Organisation for the Prohibition of Chemical Weapons
Italo Calvino	diplomatic relation	Organisation for the Prohibition of Chemical Weapons
Steve Martin	diplomatic relation	People's Republic of China
Guy de Maupassant	member of	Organization for Security and Co-operation in Europe
Haruki Murakami	diplomatic relation	Multilateral Investment Guarantee Agency
Mika	residence	Multilateral Investment Guarantee Agency
Dave Matthews	languages spoken, written, or signed	International Centre for Settlement of Investment Disputes
Lea Salonga	country of citizenship	Organisation for the Prohibition of Chemical Weapons
Lance Bass	occupation	"African, Caribbean and Pacific Group of States"
Rainer Werner Fassbinder	languages spoken, written, or signed	Agency for the Prohibition of Nuclear Weapons in Latin America and the Caribbean
Jean-Paul Sartre	occupation	"African, Caribbean and Pacific Group of States"
Gladys Knight	member of	Multilateral Investment Guarantee Agency
Turkmenistan	diplomatic relation	Organization for Security and Co-operation in Europe
Armenia	member of	International Centre for Settlement of Investment Disputes
Tomáš Garrigue Masaryk	occupation	International Centre for Settlement of Investment Disputes
São Tomé and Príncipe	genre	Agency for the Prohibition of Nuclear Weapons in Latin America and the Caribbean
John Milton	ethnic group	Multilateral Investment Guarantee Agency
Ric Ocasek	occupation	International Centre for Settlement of Investment Disputes
Mikhail Vassilyevich Lomonosov	member of	Organisation for the Prohibition of Chemical Weapons
Wilhelm Blaschke	occupation	Organisation for the Prohibition of Chemical Weapons
Nino Manfredi	occupation	Organisation for the Prohibition of Chemical Weapons
Herman Melville	genre	Organisation for the Prohibition of Chemical Weapons
Harold Bloom	diplomatic relation	International Centre for Settlement of Investment Disputes
Neil Gaiman	occupation	International Centre for Settlement of Investment Disputes
Hermann Burmeister	occupation	Organization for Security and Co-operation in Europe
Guy de Maupassant	occupation	Organization for Security and Co-operation in Europe
Bosnia and Herzegovina	genre	Organisation for the Prohibition of Chemical Weapons
Simon Newcomb	occupation	International Centre for Settlement of Investment Disputes
Sebastian Haffner	occupation	International Centre for Settlement of Investment Disputes
Rudolf Christoph Eucken	member of	International Centre for Settlement of Investment Disputes
Jack Black	influenced by	Organisation for the Prohibition of Chemical Weapons
Jordan	member of	Multilateral Investment Guarantee Agency
Parlophone	occupation	Multilateral Investment Guarantee Agency
MC Hammer	occupation	International Centre for Settlement of Investment Disputes
Joe Cocker	member of	Organisation for the Prohibition of Chemical Weapons
Democratic Republic of the Congo	influenced by	Organisation for the Prohibition of Chemical Weapons
Suriname	child	"African, Caribbean and Pacific Group of States"
Lena Meyer-Landrut	genre	Organization for Security and Co-operation in Europe
Johann Christoph Gottsched	member of	Organisation for the Prohibition of Chemical Weapons
Antonin Artaud	occupation	International Bank for Reconstruction and Development
Monica	country	International Centre for Settlement of Investment Disputes
François Guizot	religion	Organisation for the Prohibition of Chemical Weapons
Levon Helm	occupation	International Centre for Settlement of Investment Disputes
John Denver	instrument	"African, Caribbean and Pacific Group of States"
Jodie Foster	residence	"African, Caribbean and Pacific Group of States"
Enzo Jannacci	occupation	Organisation for the Prohibition of Chemical Weapons
Thomas Carlyle	diplomatic relation	Organisation for the Prohibition of Chemical Weapons
Bill Haley	instrument	International Centre for Settlement of Investment Disputes
Nikolay Basov	occupation	Organisation for the Prohibition of Chemical Weapons
Ted Nugent	occupation	International Centre for Settlement of Investment Disputes
Philip Glass	diplomatic relation	Organisation for the Prohibition of Chemical Weapons
RuPaul	occupation	"African, Caribbean and Pacific Group of States"
Sergei Korolev	record label	Organisation for the Prohibition of Chemical Weapons
Andorra	occupation	International Centre for Settlement of Investment Disputes
Soulja Boy	occupation	Organisation for the Prohibition of Chemical Weapons
Liberia	member of	International Centre for Settlement of Investment Disputes
George Henschel	occupation	Organization for Security and Co-operation in Europe
Luis Alberto Spinetta	occupation	International Centre for Settlement of Investment Disputes
Buckminster Fuller	occupation	Organisation for the Prohibition of Chemical Weapons
Jean-Baptiste Biot	diplomatic relation	Organisation for the Prohibition of Chemical Weapons
Liechtenstein	member of	Organization for Security and Co-operation in Europe
Hugo Grotius	occupation	Organisation for the Prohibition of Chemical Weapons
Libya	member of	Organisation for the Prohibition of Chemical Weapons
Anastacia	country of citizenship	"African, Caribbean and Pacific Group of States"
The Edge	country of citizenship	Multilateral Investment Guarantee Agency
Suzi Quatro	occupation	International Centre for Settlement of Investment Disputes
Spike Milligan	diplomatic relation	Organisation for the Prohibition of Chemical Weapons
Miley Cyrus	country of citizenship	International Centre for Settlement of Investment Disputes
Mick Jagger	country of citizenship	Multilateral Investment Guarantee Agency
Pier Paolo Pasolini	member of	International Centre for Settlement of Investment Disputes
Bruce Springsteen	cause of death	Organisation for the Prohibition of Chemical Weapons
Gladys Knight	occupation	Organisation for the Prohibition of Chemical Weapons
Marcellin Berthelot	member of	International Bank for Reconstruction and Development
Andrei Konchalovsky	member of	"African, Caribbean and Pacific Group of States"
Veniamin Smekhov	country of citizenship	Multilateral Investment Guarantee Agency
T.I.	occupation	International Centre for Settlement of Investment Disputes
Karl Lachmann	occupation	International Centre for Settlement of Investment Disputes
Harry Nilsson	genre	Organisation for the Prohibition of Chemical Weapons
Jerry Lewis	diplomatic relation	Organisation for the Prohibition of Chemical Weapons
Bhimrao Ramji Ambedkar	occupation	Organization for Security and Co-operation in Europe
Leo Strauss	occupation	African Union – United Nations Hybrid Operation in Darfur
Joyce Carol Oates	occupation	Organisation for the Prohibition of Chemical Weapons
George Martin	member of	Organisation for the Prohibition of Chemical Weapons
Sergey Lazarev	diplomatic relation	International Centre for Settlement of Investment Disputes
Melchior de Vogüé	instrument	International Centre for Settlement of Investment Disputes
Golo Mann	record label	Multilateral Investment Guarantee Agency
Kenny Rogers	member of	International Centre for Settlement of Investment Disputes
Karlheinz Stockhausen	occupation	International Bank for Reconstruction and Development
Kate Voegele	member of	Organisation for the Prohibition of Chemical Weapons
Vladimir Solovyov	occupation	Organization for Security and Co-operation in Europe
John Ciardi	instrument	"African, Caribbean and Pacific Group of States"
AJ Michalka	occupation	"African, Caribbean and Pacific Group of States"
Kate Voegele	member of	Organisation for the Prohibition of Chemical Weapons
Mikhail Bakunin	member of	Organisation for the Prohibition of Chemical Weapons
Clint Eastwood	member of	Organisation for the Prohibition of Chemical Weapons
Guinea-Bissau	occupation	Organisation for the Prohibition of Chemical Weapons
Archibald Hill	religion	Organisation for the Prohibition of Chemical Weapons
Zemfira	diplomatic relation	Organisation for the Prohibition of Chemical Weapons
Gilles Deleuze	country of citizenship	Organisation for the Prohibition of Chemical Weapons
Bill Haley	occupation	Multilateral Investment Guarantee Agency
Van Morrison	record label	Organization for Security and Co-operation in Europe
Grenada	member of	International Centre for Settlement of Investment Disputes
Ľudovít Štúr	occupation	International Centre for Settlement of Investment Disputes
Henri Poincaré	diplomatic relation	Organisation for the Prohibition of Chemical Weapons
Angola	occupation	Organisation for the Prohibition of Chemical Weapons
Tom Wolfe	member of	"African, Caribbean and Pacific Group of States"
Parlophone	occupation	International Telecommunication Union
Mozambique	diplomatic relation	International Centre for Settlement of Investment Disputes
Kate Voegele	employer	Organisation for the Prohibition of Chemical Weapons
Gabriel Marcel	instrument	Organisation for the Prohibition of Chemical Weapons
Selena Gomez	occupation	International Centre for Settlement of Investment Disputes
Trent Reznor	diplomatic relation	International Bank for Reconstruction and Development
William H. Macy	occupation	International Bank for Reconstruction and Development
Joseph E. Stiglitz	member of	"African, Caribbean and Pacific Group of States"
Ilya Oleynikov	diplomatic relation	International Bank for Reconstruction and Development
São Tomé and Príncipe	ethnic group	Multilateral Investment Guarantee Agency
Bolivia	genre	Agency for the Prohibition of Nuclear Weapons in Latin America and the Caribbean
Kyle Gass	occupation	Organisation for the Prohibition of Chemical Weapons
Yemen	occupation	Organisation for the Prohibition of Chemical Weapons
Miguel	diplomatic relation	International Bank for Reconstruction and Development
David Hasselhoff	genre	Organization for Security and Co-operation in Europe
Theodor W. Adorno	residence	Agency for the Prohibition of Nuclear Weapons in Latin America and the Caribbean
Phil Collins	occupation	Organisation for the Prohibition of Chemical Weapons
Maria Callas	diplomatic relation	"African, Caribbean and Pacific Group of States"
Avicii	country of citizenship	Organisation for the Prohibition of Chemical Weapons
Richard Marx	occupation	Organization for Security and Co-operation in Europe
Billy Crystal	occupation	Organisation for the Prohibition of Chemical Weapons
Elmer Bernstein	educated at	Organisation for the Prohibition of Chemical Weapons
Charlotte Gainsbourg	occupation	Organization for Security and Co-operation in Europe
Malaysia	member of	Organisation for the Prohibition of Chemical Weapons
Dolly Parton	member of	International Centre for Settlement of Investment Disputes
Johann Christian Poggendorff	member of	International Centre for Settlement of Investment Disputes
Judy Garland	member of	"African, Caribbean and Pacific Group of States"
Lev Gumilyov	member of	Multilateral Investment Guarantee Agency
Jacques Rivette	genre	Organization for Security and Co-operation in Europe
Anatoly Krupnov	member of	Organisation for the Prohibition of Chemical Weapons
Austrian Empire	official language	Organisation for the Prohibition of Chemical Weapons
Solomon Islands	diplomatic relation	Organisation for the Prohibition of Chemical Weapons
Carl Sagan	occupation	International Centre for Settlement of Investment Disputes
New Zealand	member of	International Bank for Reconstruction and Development
Thomas Henry Huxley	cause of death	Organisation for the Prohibition of Chemical Weapons
Island Records	residence	African Union – United Nations Hybrid Operation in Darfur
Bulgaria	genre	International Centre for Settlement of Investment Disputes
John Farnham	genre	Organization for Security and Co-operation in Europe
George Sand	occupation	Multilateral Investment Guarantee Agency
Marietta Shaginyan	member of	International Bank for Reconstruction and Development
k.d. lang	instrument	International Bank for Reconstruction and Development
Trey Parker	occupation	Organisation for the Prohibition of Chemical Weapons
Christina Aguilera	member of	Multilateral Investment Guarantee Agency
Franz Miklosich	instrument	Organisation for the Prohibition of Chemical Weapons
Karlheinz Stockhausen	occupation	International Bank for Reconstruction and Development
Wilhelm Blaschke	member of	Multilateral Investment Guarantee Agency
Khloé Kardashian	occupation	International Bank for Reconstruction and Development
Ethiopia	occupation	Organisation for the Prohibition of Chemical Weapons
Honduras	country of citizenship	International Bank for Reconstruction and Development
Santiago Ramón y Cajal	instrument	Multilateral Investment Guarantee Agency
Ivan Turgenev	member of	Organisation for the Prohibition of Chemical Weapons
Maldives	record label	International Telecommunication Union
Philip Roth	occupation	Organisation for the Prohibition of Chemical Weapons
Mongolia	place of burial	International Centre for Settlement of Investment Disputes
Munich	member of	International Telecommunication Union
Katerina Graham	official language	Organisation for the Prohibition of Chemical Weapons
Kate Bush	member of	Organisation for the Prohibition of Chemical Weapons
Vince Gill	member of	International Bank for Reconstruction and Development
Kanye West	occupation	People's Republic of China
Che Guevara	record label	Multilateral Investment Guarantee Agency
Myanmar	movement	Agency for the Prohibition of Nuclear Weapons in Latin America and the Caribbean
Per Olov Enquist	country of citizenship	"African, Caribbean and Pacific Group of States"
Robin Thicke	member of	International Bank for Reconstruction and Development
Herbert Grönemeyer	record label	Organisation for the Prohibition of Chemical Weapons
W.E.B. Du Bois	member of	Organisation for the Prohibition of Chemical Weapons
Dennis Gabor	country of citizenship	International Bank for Reconstruction and Development
Bill Monroe	diplomatic relation	International Centre for Settlement of Investment Disputes
Antoine César Becquerel	diplomatic relation	International Bank for Reconstruction and Development
Bhutan	spouse	Organisation for the Prohibition of Chemical Weapons
Suriname	member of	Agency for the Prohibition of Nuclear Weapons in Latin America and the Caribbean
Ivan Andreyevich Krylov	occupation	"African, Caribbean and Pacific Group of States"
Arthur Schopenhauer	cause of death	International Centre for Settlement of Investment Disputes
Antoine César Becquerel	country of citizenship	International Bank for Reconstruction and Development
Heinrich Schliemann	occupation	Organization for Security and Co-operation in Europe
Benedetto Croce	occupation	"African, Caribbean and Pacific Group of States"
Ursula K. Le Guin	member of	International Centre for Settlement of Investment Disputes
Mandy Moore	occupation	International Centre for Settlement of Investment Disputes
Frédéric Chopin	diplomatic relation	International Centre for Settlement of Investment Disputes
Samoa	diplomatic relation	Organisation for the Prohibition of Chemical Weapons
Hannes Alfvén	country of citizenship	Organization for Security and Co-operation in Europe
Nikolai Fomenko	occupation	Organisation for the Prohibition of Chemical Weapons
Michail Sholokhov	occupation	People's Republic of China
Eddie Money	member of	Organisation for the Prohibition of Chemical Weapons
Mike Myers	ethnic group	International Bank for Reconstruction and Development
Albrecht von Haller	member of	Organisation for the Prohibition of Chemical Weapons
Henrik Steffens	employer	Multilateral Investment Guarantee Agency
Dennis Hopper	occupation	"African, Caribbean and Pacific Group of States"
Thomas Aquinas	ethnic group	People's Republic of China
Felipe Colombo	country of citizenship	Organisation for the Prohibition of Chemical Weapons
Yegor Letov	genre	Agency for the Prohibition of Nuclear Weapons in Latin America and the Caribbean
Jacques Rivette	headquarters location	International Telecommunication Union
Yevgeny Zamyatin	instrument	Organization for Security and Co-operation in Europe
Myanmar	occupation	Organisation for the Prohibition of Chemical Weapons
Iggy Pop	record label	International Centre for Settlement of Investment Disputes
Gabriel Marcel	cast member	"African, Caribbean and Pacific Group of States"
Paul Simon	member of	World Trade Organization
Kosovo	occupation	Organization for Security and Co-operation in Europe
Walter Scott	member of	Multilateral Investment Guarantee Agency
Wilhelm Ostwald	occupation	International Centre for Settlement of Investment Disputes
Massimo Bontempelli	diplomatic relation	International Centre for Settlement of Investment Disputes
Anatoly Krupnov	member of	Organisation for the Prohibition of Chemical Weapons
Monica	genre	International Centre for Settlement of Investment Disputes
J. K. Rowling	languages spoken, written, or signed	African Union – United Nations Hybrid Operation in Darfur
Democratic Republic of the Congo	diplomatic relation	International Bank for Reconstruction and Development
Olivier Messiaen	languages spoken, written, or signed	Multilateral Investment Guarantee Agency
Ernst Mach	occupation	Multilateral Investment Guarantee Agency
Erwin Raisz	member of	Organization for Security and Co-operation in Europe
Yoko Ono	diplomatic relation	Multilateral Investment Guarantee Agency
Clint Eastwood	occupation	International Centre for Settlement of Investment Disputes
Friedrich Schiller	diplomatic relation	International Bank for Reconstruction and Development
Fred Hoyle	diplomatic relation	International Centre for Settlement of Investment Disputes
Mongolia	occupation	Organisation for the Prohibition of Chemical Weapons
Solange Knowles	member of	Group on Earth Observations
Soviet Union	diplomatic relation	"African, Caribbean and Pacific Group of States"
Karl Lachmann	occupation	Organization for Security and Co-operation in Europe
Veniamin Smekhov	occupation	"African, Caribbean and Pacific Group of States"
Alicia Keys	record label	Organisation for the Prohibition of Chemical Weapons
Meat Loaf	member of	Multilateral Investment Guarantee Agency
Adriano Celentano	occupation	International Centre for Settlement of Investment Disputes
Shannon Leto	religion	Multilateral Investment Guarantee Agency
Suriname	occupation	Multilateral Investment Guarantee Agency
Algeria	diplomatic relation	"African, Caribbean and Pacific Group of States"
Victor Ambartsumian	country of citizenship	International Centre for Settlement of Investment Disputes
Jim Belushi	residence	International Telecommunication Union
Natalie Cole	occupation	"African, Caribbean and Pacific Group of States"
Toni Morrison	country of citizenship	International Centre for Settlement of Investment Disputes
São Tomé and Príncipe	religion	African Union – United Nations Hybrid Operation in Darfur
Zoë Kravitz	employer	Multilateral Investment Guarantee Agency
Bhutan	occupation	Multilateral Investment Guarantee Agency
Miley Cyrus	diplomatic relation	Multilateral Investment Guarantee Agency
Morocco	field of work	Organisation for the Prohibition of Chemical Weapons
Papua New Guinea	record label	International Centre for Settlement of Investment Disputes
Kid Rock	diplomatic relation	Multilateral Investment Guarantee Agency
East Timor	occupation	Organisation for the Prohibition of Chemical Weapons
Alla Pugacheva	member of	Organisation for the Prohibition of Chemical Weapons
Mick Ronson	occupation	Organisation for the Prohibition of Chemical Weapons
Ingmar Bergman	occupation	Organisation for the Prohibition of Chemical Weapons
Walter Benjamin	member of	Group on Earth Observations
Iceland	occupation	Organisation for the Prohibition of Chemical Weapons
Sheryl Crow	occupation	Group on Earth Observations
Belgium	diplomatic relation	Organisation for the Prohibition of Chemical Weapons
Ľudovít Štúr	instrument	International Centre for Settlement of Investment Disputes
Ed Sheeran	member of	International Bank for Reconstruction and Development
Wilhelm Blaschke	occupation	International Bank for Reconstruction and Development
W. H. Auden	occupation	International Centre for Settlement of Investment Disputes
August Wilhelm Schlegel	diplomatic relation	Organisation for the Prohibition of Chemical Weapons
Switzerland	member of	Organisation for the Prohibition of Chemical Weapons
Nicaragua	country of citizenship	Organisation for the Prohibition of Chemical Weapons
Arnold Schwarzenegger	part of	International Development Association
Turkmenistan	member of	People's Republic of China
Atco Records	occupation	International Telecommunication Union
Jerry Lewis	diplomatic relation	International Bank for Reconstruction and Development
Arthur Schopenhauer	languages spoken, written, or signed	Multilateral Investment Guarantee Agency
E. T. A. Hoffmann	occupation	"African, Caribbean and Pacific Group of States"
Yemen	diplomatic relation	Organisation for the Prohibition of Chemical Weapons
AJ Michalka	occupation	International Centre for Settlement of Investment Disputes
Allen Ginsberg	member of	International Bank for Reconstruction and Development
Jamie Foxx	country of citizenship	Multilateral Investment Guarantee Agency
Albert Szent-Györgyi	member of	International Centre for Settlement of Investment Disputes
Corbin Bleu	genre	International Centre for Settlement of Investment Disputes
Boris Grebenshchikov	sibling	Organisation for the Prohibition of Chemical Weapons
Equatorial Guinea	diplomatic relation	International Bank for Reconstruction and Development
Whoopi Goldberg	occupation	International Centre for Settlement of Investment Disputes
Jennifer Hudson	member of	International Centre for Settlement of Investment Disputes
Namibia	languages spoken, written, or signed	Organization for Security and Co-operation in Europe
François Guizot	occupation	People's Republic of China
C. S. Lewis	occupation	International Bank for Reconstruction and Development
Felipe Colombo	influenced by	Multilateral Investment Guarantee Agency
Fredro Starr	occupation	"African, Caribbean and Pacific Group of States"
Nikolai Gogol	occupation	Organisation internationale de la Francophonie
Harold Pinter	diplomatic relation	International Bank for Reconstruction and Development
Cape Verde	occupation	Organization for Security and Co-operation in Europe
Enzo Jannacci	occupation	Organisation for the Prohibition of Chemical Weapons
Jean-Baptiste Dumas	occupation	Organisation for the Prohibition of Chemical Weapons
Whitney Houston	member of	Organisation for the Prohibition of Chemical Weapons
Ľudovít Štúr	genre	"African, Caribbean and Pacific Group of States"
Carlo Rubbia	instrument	Organisation for the Prohibition of Chemical Weapons
Jan Josef Liefers	occupation	International Centre for Settlement of Investment Disputes
Jive	member of	Council of Europe
Renaud	member of	Multilateral Investment Guarantee Agency
Ernst Mayr	diplomatic relation	International Bank for Reconstruction and Development
T.I.	member of	International Bank for Reconstruction and Development
Émile Zola	educated at	Organisation for the Prohibition of Chemical Weapons
Henry Wadsworth Longfellow	record label	International Centre for Settlement of Investment Disputes
Condoleezza Rice	languages spoken, written, or signed	International Telecommunication Union
People's Republic of China	member of	International Bank for Reconstruction and Development
Colbie Caillat	occupation	Organisation for the Prohibition of Chemical Weapons
T. S. Eliot	influenced by	Organisation for the Prohibition of Chemical Weapons
Fiji	occupation	International Centre for Settlement of Investment Disputes
Switzerland	occupation	International Bank for Reconstruction and Development
Jacob Grimm	member of	Organisation for the Prohibition of Chemical Weapons
North Macedonia	occupation	Organisation for the Prohibition of Chemical Weapons
Harald Weinrich	occupation	International Centre for Settlement of Investment Disputes
Sakis Rouvas	child	International Centre for Settlement of Investment Disputes
Bill Haley	occupation	Multilateral Investment Guarantee Agency
David Ogden Stiers	occupation	Multilateral Investment Guarantee Agency
Moritz von Jacobi	occupation	International Bank for Reconstruction and Development
Amr Diab	member of	International Centre for Settlement of Investment Disputes
Alexander Alexandrovich Fadeyev	diplomatic relation	Multilateral Investment Guarantee Agency
United States of America	member of	Organisation for the Prohibition of Chemical Weapons
Felipe Colombo	occupation	"African, Caribbean and Pacific Group of States"
Vince Neil	occupation	Agency for the Prohibition of Nuclear Weapons in Latin America and the Caribbean
Ľudovít Štúr	ethnic group	International Centre for Settlement of Investment Disputes
Hugh Laurie	place of birth	International Bank for Reconstruction and Development
David Foster	occupation	Organisation for the Prohibition of Chemical Weapons
50 Cent	ethnic group	Organisation for the Prohibition of Chemical Weapons
Theodore Roosevelt	member of	International Bank for Reconstruction and Development
Peter Tork	record label	Organization for Security and Co-operation in Europe
Dudley Moore	influenced by	International Hydrographic Organization
Vietnam	genre	International Centre for Settlement of Investment Disputes
Ray Lankester	diplomatic relation	Multilateral Investment Guarantee Agency
Jeff Goldblum	diplomatic relation	Organization for Security and Co-operation in Europe
Stephen Hawking	record label	Multilateral Investment Guarantee Agency
Miguel de Unamuno	occupation	People's Republic of China
Heinrich Schliemann	occupation	Multilateral Investment Guarantee Agency
Günter Grass	occupation	International Bank for Reconstruction and Development
Van McCoy	occupation	Organization for Security and Co-operation in Europe
Dmitry Medvedev	occupation	People's Republic of China
Rob Zombie	child	International Bank for Reconstruction and Development
Yoko Ono	occupation	Organisation for the Prohibition of Chemical Weapons
Barbados	religion	Organisation for the Prohibition of Chemical Weapons
Joan Jett	genre	Organisation for the Prohibition of Chemical Weapons
Roman Jakobson	record label	Organization for Security and Co-operation in Europe
Clive Barker	member of	International Bank for Reconstruction and Development
Karl Popper	ethnic group	Organisation for the Prohibition of Chemical Weapons
George Porter, Baron Porter of Luddenham	occupation	Organisation for the Prohibition of Chemical Weapons
Joyce Carol Oates	occupation	Organisation for the Prohibition of Chemical Weapons
Charles Bukowski	occupation	International Telecommunication Union
The Edge	employer	International Finance Corporation
Venezuela	occupation	Multilateral Investment Guarantee Agency
Bruce Springsteen	member of	International Development Association
People's Republic of China	member of	International Centre for Settlement of Investment Disputes
Papua New Guinea	occupation	International Centre for Settlement of Investment Disputes
Friedrich Schiller	genre	People's Republic of China
Yoram Kaniuk	diplomatic relation	Multilateral Investment Guarantee Agency
Malta	occupation	International Bank for Reconstruction and Development
Uganda	member of	International Bank for Reconstruction and Development
August Ludwig von Schlözer	member of	Organisation for the Prohibition of Chemical Weapons
Guy de Maupassant	occupation	African Union – United Nations Hybrid Operation in Darfur
Steven Van Zandt	occupation	Group on Earth Observations
Kenneth Burke	occupation	Multilateral Investment Guarantee Agency
Kyrgyzstan	diplomatic relation	People's Republic of China
Donovan	occupation	International Telecommunication Union
Charles Baudelaire	educated at	International Centre for Settlement of Investment Disputes
Ludvig Holberg	diplomatic relation	International Bank for Reconstruction and Development
Zdeněk Nejedlý	instrument	Multilateral Investment Guarantee Agency
Billy Crystal	occupation	Multilateral Investment Guarantee Agency
Luciano Berio	diplomatic relation	Organisation internationale de la Francophonie
Kuwait	diplomatic relation	International Centre for Settlement of Investment Disputes
Sergey Kuryokhin	occupation	International Centre for Settlement of Investment Disputes
Paraguay	country	"African, Caribbean and Pacific Group of States"
Sudan	occupation	International Centre for Settlement of Investment Disputes
Eldar Ryazanov	occupation	Organisation for the Prohibition of Chemical Weapons
Ernest Hemingway	occupation	International Telecommunication Union
Alfred Schnittke	member of	African Union – United Nations Hybrid Operation in Darfur
Ingmar Bergman	languages spoken, written, or signed	Organisation for the Prohibition of Chemical Weapons
Laos	genre	International Bank for Reconstruction and Development
Frank Zappa	religion	"African, Caribbean and Pacific Group of States"
Justin Bieber	member of	International Bank for Reconstruction and Development
Vanessa Carlton	occupation	Multilateral Investment Guarantee Agency
United Arab Emirates	occupation	International Centre for Settlement of Investment Disputes
Harry Nilsson	diplomatic relation	Agency for the Prohibition of Nuclear Weapons in Latin America and the Caribbean
Singapore	occupation	Multilateral Investment Guarantee Agency
Arthur Conan Doyle	diplomatic relation	Multilateral Investment Guarantee Agency
Somalia	instrument	International Centre for Settlement of Investment Disputes
Bob Dylan	country of citizenship	International Telecommunication Union
Fergie	place of birth	International Bank for Reconstruction and Development
Lev Gumilyov	occupation	"African, Caribbean and Pacific Group of States"
John Frederick William Herschel	occupation	International Centre for Settlement of Investment Disputes
Dominican Republic	diplomatic relation	Organisation for the Prohibition of Chemical Weapons
Slovakia	diplomatic relation	Organisation for the Prohibition of Chemical Weapons
Jean-Jacques Rousseau	influenced by	Multilateral Investment Guarantee Agency
Hayley Williams	instrument	"African, Caribbean and Pacific Group of States"
Richard Wagner	member of	International Centre for Settlement of Investment Disputes
Archibald Hill	occupation	People's Republic of China
Glen Campbell	occupation	Multilateral Investment Guarantee Agency
Israel	place of death	Organisation for the Prohibition of Chemical Weapons
Meaghan Jette Martin	influenced by	Organisation internationale de la Francophonie
Alexis de Tocqueville	residence	International Bank for Reconstruction and Development
Aram Khachaturian	instrument	International Centre for Settlement of Investment Disputes
Victoria Beckham	genre	Multilateral Investment Guarantee Agency
Eric Burdon	diplomatic relation	International Bank for Reconstruction and Development
Roger Miller	occupation	Organisation for the Prohibition of Chemical Weapons
Ice Cube	member of	Multilateral Investment Guarantee Agency
Janis Ian	country of citizenship	People's Republic of China
Dima Bilan	member of	Organisation for the Prohibition of Chemical Weapons
Wolfhart Pannenberg	influenced by	Agency for the Prohibition of Nuclear Weapons in Latin America and the Caribbean
Busta Rhymes	instrument	International Bank for Reconstruction and Development
Ludwig Prandtl	occupation	Organization for Security and Co-operation in Europe
Peter Gay	occupation	African Union – United Nations Hybrid Operation in Darfur
Kuwait	instrument	Organisation for the Prohibition of Chemical Weapons
Alice Cooper	diplomatic relation	International Bank for Reconstruction and Development
Nick Cave	country	International Centre for Settlement of Investment Disputes
Turkey	religion	Organisation for the Prohibition of Chemical Weapons
Sergei Korolev	occupation	Organization for Security and Co-operation in Europe
St. Vincent	languages spoken, written, or signed	International Bank for Reconstruction and Development
Tuvalu	member of	International Bank for Reconstruction and Development
Wiz Khalifa	languages spoken, written, or signed	African Union – United Nations Hybrid Operation in Darfur
Albania	diplomatic relation	Organisation for the Prohibition of Chemical Weapons
Chad	member of	International Bank for Reconstruction and Development
Harry Connick Jr.	languages spoken, written, or signed	International Centre for Settlement of Investment Disputes
Philippines	instrument	International Centre for Settlement of Investment Disputes
Sabrina Bryan	occupation	People's Republic of China
Barbara Mandrell	employer	Multilateral Investment Guarantee Agency
Libya	occupation	International Centre for Settlement of Investment Disputes
Jolin Tsai	occupation	African Union – United Nations Hybrid Operation in Darfur
Rudolf Virchow	occupation	Organisation for the Prohibition of Chemical Weapons
Eswatini	employer	International Bank for Reconstruction and Development
Solomon Islands	member of	People's Republic of China
Little Richard	languages spoken, written, or signed	"African, Caribbean and Pacific Group of States"
Albania	diplomatic relation	International Centre for Settlement of Investment Disputes
Joe Dassin	field of work	Multilateral Investment Guarantee Agency
Carlo Rubbia	diplomatic relation	Organisation for the Prohibition of Chemical Weapons
Mariah Carey	occupation	International Bank for Reconstruction and Development
Pedro II of Brazil	record label	"African, Caribbean and Pacific Group of States"
Rick Rubin	ethnic group	Organisation for the Prohibition of Chemical Weapons
John Cage	member of	"African, Caribbean and Pacific Group of States"
Clive Barker	occupation	Organization for Security and Co-operation in Europe
Salvador de Madariaga	occupation	"African, Caribbean and Pacific Group of States"
Venezuela	occupation	International Bank for Reconstruction and Development
Philippines	diplomatic relation	International Centre for Settlement of Investment Disputes
Kiely Williams	member of	International Telecommunication Union
Gilles Deleuze	languages spoken, written, or signed	Multilateral Investment Guarantee Agency
Martin Buber	diplomatic relation	Organisation for the Prohibition of Chemical Weapons
Angélique Kidjo	member of	Multilateral Investment Guarantee Agency
Belarus	record label	International Telecommunication Union
Big Boi	instrument	Multilateral Investment Guarantee Agency
South Korea	member of	Organisation for the Prohibition of Chemical Weapons
Emma Bunton	diplomatic relation	International Telecommunication Union
James Cameron	occupation	Organisation for the Prohibition of Chemical Weapons
Jason Mraz	occupation	International Telecommunication Union
Kosovo	country of citizenship	Multilateral Investment Guarantee Agency
Marilyn Manson	diplomatic relation	Organisation for the Prohibition of Chemical Weapons
Tom Hanks	occupation	World Trade Organization
Saul Williams	occupation	International Hydrographic Organization
Sidney Poitier	genre	International Bank for Reconstruction and Development
Charles Baudelaire	occupation	Organisation for the Prohibition of Chemical Weapons
Russell Brand	record label	"African, Caribbean and Pacific Group of States"
Boris Grebenshchikov	diplomatic relation	Organisation for the Prohibition of Chemical Weapons
People's Republic of China	member of	Guinea
Kenny Rogers	member of	Multilateral Investment Guarantee Agency
Prosper Mérimée	languages spoken, written, or signed	International Bank for Reconstruction and Development
Ivan Yefremov	member of	Multilateral Investment Guarantee Agency
Gambia	record label	Agency for the Prohibition of Nuclear Weapons in Latin America and the Caribbean
J. R. R. Tolkien	languages spoken, written, or signed	International Bank for Reconstruction and Development
Joseph Priestley	occupation	International Bank for Reconstruction and Development
Stephen Hawking	member of	"African, Caribbean and Pacific Group of States"
Samoa	diplomatic relation	African Union – United Nations Hybrid Operation in Darfur
Nick Cannon	member of	Multilateral Investment Guarantee Agency
Benjamin Franklin	member of	International Centre for Settlement of Investment Disputes
Yevgeny Zamyatin	occupation	Multilateral Investment Guarantee Agency
Ray Charles	genre	International Centre for Settlement of Investment Disputes
Fritz Haber	occupation	International Bank for Reconstruction and Development
Anthony Burgess	occupation	International Centre for Settlement of Investment Disputes
South Korea	diplomatic relation	International Bank for Reconstruction and Development
Mali	instrument	International Centre for Settlement of Investment Disputes
Ellie Goulding	diplomatic relation	Multilateral Investment Guarantee Agency
Ludwig Prandtl	member of	Group on Earth Observations
Noam Chomsky	member of	Organisation for the Prohibition of Chemical Weapons
Ray Davies	occupation	Organisation for the Prohibition of Chemical Weapons
Kenya	member of	International Bank for Reconstruction and Development
Sky Ferreira	languages spoken, written, or signed	International Telecommunication Union
Adam Lambert	ethnic group	Organisation for the Prohibition of Chemical Weapons
Brunei	languages spoken, written, or signed	Multilateral Investment Guarantee Agency
Thailand	genre	Multilateral Investment Guarantee Agency
Vitaly Ginzburg	genre	International Bank for Reconstruction and Development
John de Lancie	field of work	International Telecommunication Union
Mikhail Zadornov	genre	Organisation internationale de la Francophonie
Lord Byron	occupation	International Centre for Settlement of Investment Disputes
Ben Stiller	occupation	Agency for the Prohibition of Nuclear Weapons in Latin America and the Caribbean
Eduard Limonov	occupation	People's Republic of China
Patti Smith	employer	International Bank for Reconstruction and Development
Ferdinand von Richthofen	occupation	International Bank for Reconstruction and Development
Pavel Jozef Šafárik	languages spoken, written, or signed	International Bank for Reconstruction and Development
Ashanti	occupation	International Bank for Reconstruction and Development
Eugène Ionesco	occupation	International Centre for Settlement of Investment Disputes
Lil Mama	country of citizenship	International Bank for Reconstruction and Development
Yoko Ono	country of citizenship	Organisation for the Prohibition of Chemical Weapons
Honoré de Balzac	occupation	International Bank for Reconstruction and Development
Ingeborg Bachmann	place of death	International Development Association
Paul McCartney	member of	"African, Caribbean and Pacific Group of States"
Uzbekistan	occupation	Organisation for the Prohibition of Chemical Weapons
Virginia Woolf	occupation	Multilateral Investment Guarantee Agency
Tyrese Gibson	occupation	Universal Postal Union
Robin Thicke	notable works	Organisation for the Prohibition of Chemical Weapons
Johann Christian Poggendorff	occupation	Group on Earth Observations
Veniamin Smekhov	occupation	International Telecommunication Union
Belarus	member of	Organization for Security and Co-operation in Europe
Angela Merkel	diplomatic relation	Group on Earth Observations
Brigitte Bardot	occupation	Multilateral Investment Guarantee Agency
Libya	educated at	Organisation for the Prohibition of Chemical Weapons
Beth Hart	occupation	International Bank for Reconstruction and Development
Karl Lachmann	occupation	Multilateral Investment Guarantee Agency
Donald Trump	occupation	Group on Earth Observations
Mikhail Vassilyevich Lomonosov	genre	Multilateral Investment Guarantee Agency
Moritz von Jacobi	member of	Multilateral Investment Guarantee Agency
Mali	diplomatic relation	People's Republic of China
David Hemmings	instrument	Organisation internationale de la Francophonie
Count Basie	occupation	African Union – United Nations Hybrid Operation in Darfur
Bobby Scott	occupation	International Telecommunication Union
William Shatner	occupation	African Union – United Nations Hybrid Operation in Darfur
Ryan Tedder	occupation	International Bank for Reconstruction and Development
Laos	diplomatic relation	International Telecommunication Union
Federated States of Micronesia	diplomatic relation	Group on Earth Observations
Charles Mingus Jr.	occupation	International Telecommunication Union
Shannon Leto	occupation	International Bank for Reconstruction and Development
Seychelles	diplomatic relation	International Telecommunication Union
Gloria Trevi	diplomatic relation	People's Republic of China
Saint Lucia	genre	Group on Earth Observations
Cliff Richard	country of citizenship	Multilateral Investment Guarantee Agency
Djibouti	instrument	Organization for Security and Co-operation in Europe
Igor Stravinsky	occupation	Organisation for the Prohibition of Chemical Weapons
Paul Jozef Crutzen	diplomatic relation	Multilateral Investment Guarantee Agency
Jean Renoir	member of	International Telecommunication Union
Vitas	occupation	International Finance Corporation
Duke Ellington	occupation	Organisation for the Prohibition of Chemical Weapons
Julian Fellowes	genre	Agency for the Prohibition of Nuclear Weapons in Latin America and the Caribbean
Jeff Bridges	country of citizenship	"African, Caribbean and Pacific Group of States"
Morocco	languages spoken, written, or signed	International Centre for Settlement of Investment Disputes
Tony Visconti	languages spoken, written, or signed	International Telecommunication Union
Jean Cocteau	genre	International Centre for Settlement of Investment Disputes
Ike Turner	occupation	Organisation for the Prohibition of Chemical Weapons
Erika Mann	instrument	Organisation for the Prohibition of Chemical Weapons
Holly Johnson	instrument	Multilateral Investment Guarantee Agency
Bosnia and Herzegovina	diplomatic relation	People's Republic of China
Joumana Haddad	occupation	Multilateral Investment Guarantee Agency
Netherlands	place of death	International Bank for Reconstruction and Development
Brian May	country of citizenship	International Centre for Settlement of Investment Disputes
Simon Newcomb	diplomatic relation	International Centre for Settlement of Investment Disputes
Sir George Stokes, 1st Baronet	occupation	Multilateral Investment Guarantee Agency
Woody Allen	field of work	People's Republic of China
Donny Osmond	languages spoken, written, or signed	Organisation for the Prohibition of Chemical Weapons
United States of America	member of	International Centre for Settlement of Investment Disputes
Lonnie Liston Smith	country of citizenship	International Bank for Reconstruction and Development
Kid Cudi	diplomatic relation	African Union – United Nations Hybrid Operation in Darfur
Joseph Liouville	member of	People's Republic of China
Venezuela	member of	International Telecommunication Union
Wassily Kandinsky	occupation	People's Republic of China
Neil Tennant	diplomatic relation	International Bank for Reconstruction and Development
Robert Musil	occupation	Organisation internationale de la Francophonie
Jacobus Henricus van 't Hoff	member of	African Union – United Nations Hybrid Operation in Darfur
Violetta Villas	occupation	Group on Earth Observations
August Ludwig von Schlözer	languages spoken, written, or signed	International Telecommunication Union
Jackie Jackson	instrument	World Trade Organization
Benedetto Croce	occupation	International Bank for Reconstruction and Development
Anthony Burgess	member of	International Bank for Reconstruction and Development
Søren Kierkegaard	ethnic group	Multilateral Investment Guarantee Agency
Khloé Kardashian	residence	International Telecommunication Union
Spike Lee	diplomatic relation	International Telecommunication Union
Richard Wright	diplomatic relation	People's Republic of China
Keri Hilson	place of birth	"African, Caribbean and Pacific Group of States"
Bangladesh	employer	Multilateral Investment Guarantee Agency
Ice Cube	occupation	People's Republic of China
Yoshiki	member of	African Development Bank
Michael Bublé	country of citizenship	"African, Caribbean and Pacific Group of States"
Saudi Arabia	occupation	International Centre for Settlement of Investment Disputes
Yasmina Reza	member of	Organisation for the Prohibition of Chemical Weapons
Fredric Jameson	occupation	International Bank for Reconstruction and Development
Ariana Grande	occupation	International Centre for Settlement of Investment Disputes
Salvador de Madariaga	member of	International Bank for Reconstruction and Development
Lionel Hampton	occupation	Group on Earth Observations
Uzeyir Hajibeyov	occupation	International Centre for Settlement of Investment Disputes
James Brown	occupation	"African, Caribbean and Pacific Group of States"
Mario Praz	occupation	International Bank for Reconstruction and Development
Yemen	diplomatic relation	People's Republic of China
Ric Ocasek	member of	People's Republic of China
Seth MacFarlane	instrument	Group on Earth Observations
Margaret Atwood	diplomatic relation	Organisation for the Prohibition of Chemical Weapons
William Morris	religion	International Bank for Reconstruction and Development
Douglas Fairbanks	diplomatic relation	People's Republic of China
Hayley Kiyoko	occupation	International Centre for Settlement of Investment Disputes
Joe Walsh	educated at	African Union – United Nations Hybrid Operation in Darfur
Eminem	occupation	International Bank for Reconstruction and Development
United Kingdom	genre	International Centre for Settlement of Investment Disputes
Tuvalu	occupation	Group on Earth Observations
Kiribati	record label	International Telecommunication Union
Václav Havel	occupation	People's Republic of China
Claude Lévi-Strauss	record label	Organization for Security and Co-operation in Europe
Czech Republic	occupation	International Centre for Settlement of Investment Disputes
Bulgaria	member of	Organisation for the Prohibition of Chemical Weapons
Angola	place of death	International Finance Corporation
Enzo Jannacci	member of	Organisation for the Prohibition of Chemical Weapons
Gabriel García Márquez	member of	Group on Earth Observations
Walt Disney Records	member of	International Development Association
Harald Weinrich	country of citizenship	African Union – United Nations Hybrid Operation in Darfur
Richard Francis Burton	occupation	World Trade Organization
T. S. Eliot	occupation	Organisation for the Prohibition of Chemical Weapons
Robert Downey, Jr.	continent	International Telecommunication Union
Ludacris	diplomatic relation	Multilateral Investment Guarantee Agency
David Cross	occupation	Group on Earth Observations
Charlie Chaplin	member of	People's Republic of China
Jean Renoir	diplomatic relation	International Hydrographic Organization
W.E.B. Du Bois	member of	Universal Postal Union
Leonardo da Vinci	diplomatic relation	International Telecommunication Union
Indonesia	diplomatic relation	Organisation for the Prohibition of Chemical Weapons
Kenneth Burke	residence	International Finance Corporation
Theodosius Dobzhansky	record label	Multilateral Investment Guarantee Agency
Billy Joel	record label	Multilateral Investment Guarantee Agency
Sidney Sheldon	influenced by	Organisation internationale de la Francophonie
Paraguay	occupation	International Centre for Settlement of Investment Disputes
Andy Griffith	child	People's Republic of China
Leszek Kołakowski	occupation	Organisation for the Prohibition of Chemical Weapons
United Arab Emirates	languages spoken, written, or signed	International Centre for Settlement of Investment Disputes
Vladimir Mayakovsky	religion	Group on Earth Observations
György Lukács	diplomatic relation	African Union – United Nations Hybrid Operation in Darfur
Judy Garland	occupation	International Centre for Settlement of Investment Disputes
H. P. Lovecraft	occupation	International Hydrographic Organization
Tajikistan	occupation	International Telecommunication Union
John von Neumann	religion	Multilateral Investment Guarantee Agency
Walker Percy	member of	International Bank for Reconstruction and Development
Alanis Morissette	occupation	International Centre for Settlement of Investment Disputes
Jean-Paul Sartre	diplomatic relation	International Bank for Reconstruction and Development
England	occupation	International Telecommunication Union
Samuel R. Delany	part of	Organisation internationale de la Francophonie
Gloria Trevi	member of	African Development Bank
People's Republic of China	diplomatic relation	Agency for the Prohibition of Nuclear Weapons in Latin America and the Caribbean
Turkey	occupation	International Centre for Settlement of Investment Disputes
Meat Loaf	member of	Organization for Security and Co-operation in Europe
Bahrain	residence	Multilateral Investment Guarantee Agency
Greece	occupation	Organisation for the Prohibition of Chemical Weapons
Augustine of Hippo	member of	International Development Association
Slovakia	languages spoken, written, or signed	International Centre for Settlement of Investment Disputes
George Sand	genre	People's Republic of China
Leo Strauss	place of death	International Telecommunication Union
Mircea Eliade	occupation	Organisation internationale de la Francophonie
Vladimir Solovyov	diplomatic relation	Multilateral Investment Guarantee Agency
Lil' Kim	instrument	International Development Association
Sudan	official language	Organisation for the Prohibition of Chemical Weapons
Pierre Boulez	member of	People's Republic of China
Tinashe	occupation	International Centre for Settlement of Investment Disputes
Gabriel García Márquez	member of	International Telecommunication Union
Wolfhart Pannenberg	member of	Multilateral Investment Guarantee Agency
Theodor Nöldeke	occupation	International Bank for Reconstruction and Development
New Zealand	occupation	Multilateral Investment Guarantee Agency
Jean-Antoine-Nicolas de Caritat de Condorcet	educated at	Boris Vian
Buckminster Fuller	member of	International Telecommunication Union
Fiona Apple	member of	World Trade Organization
Rabindranath Tagore	occupation	Multilateral Investment Guarantee Agency
Alan Stivell	member of	International Bank for Reconstruction and Development
Giuseppe Ungaretti	diplomatic relation	International Bank for Reconstruction and Development
Stanisław Lem	occupation	African Union – United Nations Hybrid Operation in Darfur
Anna Karina	genre	Agency for the Prohibition of Nuclear Weapons in Latin America and the Caribbean
Noam Chomsky	influenced by	International Development Association
Eugène Ionesco	diplomatic relation	"African, Caribbean and Pacific Group of States"
Republic of the Congo	instrument	International Bank for Reconstruction and Development
Eminem	occupation	International Telecommunication Union
Burkina Faso	occupation	African Union – United Nations Hybrid Operation in Darfur
Nahum Sokolow	occupation	International Finance Corporation
Boris Vian	occupation	Organisation internationale de la Francophonie
Mickey Rooney	member of	Organization for Security and Co-operation in Europe
Mary J. Blige	member of	Multilateral Investment Guarantee Agency
Kingsley Amis	diplomatic relation	International Bank for Reconstruction and Development
Bosnia and Herzegovina	diplomatic relation	El Salvador
Sweden	occupation	International Bank for Reconstruction and Development
Renaud	diplomatic relation	International Bank for Reconstruction and Development
Eduard Limonov	diplomatic relation	International Telecommunication Union
Drake	occupation	International Centre for Settlement of Investment Disputes
Guglielmo Marconi	occupation	African Union – United Nations Hybrid Operation in Darfur
People's Republic of China	country	Djibouti
Gene Simmons	member of	Multilateral Investment Guarantee Agency
Uzeyir Hajibeyov	country of citizenship	International Bank for Reconstruction and Development
Namibia	occupation	International Bank for Reconstruction and Development
LeToya Luckett	member of	International Hydrographic Organization
Gottfried Wilhelm Leibniz	continent	Organisation for the Prohibition of Chemical Weapons
Stefan Zweig	member of	Organisation internationale de la Francophonie
Hilary Duff	diplomatic relation	International Finance Corporation
Malta	occupation	International Bank for Reconstruction and Development
Alice Walker	instrument	International Bank for Reconstruction and Development
Valery Leontiev	diplomatic relation	International Centre for Settlement of Investment Disputes
Ike Turner	genre	International Telecommunication Union
Ani Lorak	member of	International Telecommunication Union
Turkey	occupation	International Bank for Reconstruction and Development
Pierre-Simon Laplace	member of	International Centre for Settlement of Investment Disputes
Palau	occupation	People's Republic of China
Ernst Troeltsch	genre	Multilateral Investment Guarantee Agency
John Legend	country of citizenship	International Development Association
Charles Dickens	occupation	Group on Earth Observations
Costa Rica	member of	Organisation internationale de la Francophonie
Eleanor Roosevelt	diplomatic relation	Multilateral Investment Guarantee Agency
Henry Louis Gates	ethnic group	Multilateral Investment Guarantee Agency
Ecuador	member of	Organization for Security and Co-operation in Europe
Vietnam	country of citizenship	Organization for Security and Co-operation in Europe
John Lennon	member of	International Bank for Reconstruction and Development
Alice Walker	genre	International Telecommunication Union
Simone de Beauvoir	diplomatic relation	International Bank for Reconstruction and Development
Greece	occupation	International Centre for Settlement of Investment Disputes
Mario Vargas Llosa	diplomatic relation	International Hydrographic Organization
Teena Marie	occupation	International Bank for Reconstruction and Development
Denmark	diplomatic relation	Organisation for the Prohibition of Chemical Weapons
Portugal	occupation	Multilateral Investment Guarantee Agency
Yeshayahu Leibowitz	place of birth	International Bank for Reconstruction and Development
Pyotr Ilyich Tchaikovsky	occupation	International Development Association
Malaysia	diplomatic relation	International Bank for Reconstruction and Development
Charles Aznavour	occupation	International Bank for Reconstruction and Development
Lisa Marie Presley	occupation	World Trade Organization
Malawi	occupation	International Bank for Reconstruction and Development
Bosnia and Herzegovina	genre	Group on Earth Observations
Slovenia	employer	Multilateral Investment Guarantee Agency
Jean Le Rond d'Alembert	occupation	Organization for Security and Co-operation in Europe
Priscilla Presley	place of death	Organisation internationale de la Francophonie
Carlos Fuentes	country of citizenship	International Telecommunication Union
Violetta Villas	diplomatic relation	Organisation for the Prohibition of Chemical Weapons
Qatar	occupation	International Telecommunication Union
Soviet Union	occupation	International Bank for Reconstruction and Development
Greece	genre	International Centre for Settlement of Investment Disputes
Geddy Lee	country of citizenship	Organisation for the Prohibition of Chemical Weapons
Lara Fabian	languages spoken, written, or signed	International Bank for Reconstruction and Development
Saint Lucia	member of	People's Republic of China
Thailand	diplomatic relation	People's Republic of China
Chris Martin	occupation	Organisation for the Prohibition of Chemical Weapons
Cape Verde	occupation	International Bank for Reconstruction and Development
Japan	ethnic group	International Bank for Reconstruction and Development
Lonnie Liston Smith	occupation	International Hydrographic Organization
Dietrich Fischer-Dieskau	occupation	People's Republic of China
Adam Lambert	place of birth	International Telecommunication Union
Faith Evans	diplomatic relation	"African, Caribbean and Pacific Group of States"
Albania	languages spoken, written, or signed	International Telecommunication Union
Mozambique	occupation	People's Republic of China
Kazakhstan	medical condition	Group on Earth Observations
Anastacia	occupation	International Telecommunication Union
Peter Lorre	member of	Nuclear Suppliers Group
Bob Hope	occupation	People's Republic of China
Moby	sibling	International Telecommunication Union
Ricky Martin	occupation	Group on Earth Observations
Chris Cornell	ethnic group	International Bank for Reconstruction and Development
Latvia	genre	People's Republic of China
Hu Shih	occupation	International Bank for Reconstruction and Development
Central African Republic	occupation	Multilateral Investment Guarantee Agency
Jacob Grimm	instrument	Organisation for the Prohibition of Chemical Weapons
Otto Schmidt	member of	International Bank for Reconstruction and Development
Croatia	country of citizenship	"African, Caribbean and Pacific Group of States"
Bahrain	occupation	Multilateral Investment Guarantee Agency
Jeff Goldblum	member of	International Development Association
Saint Vincent and the Grenadines	diplomatic relation	International Telecommunication Union
Morocco	member of	International Telecommunication Union
Paul McCartney	employer	International Bank for Reconstruction and Development
Marlon Jackson	country of citizenship	International Bank for Reconstruction and Development
Robert Musil	diplomatic relation	International Development Association
Bernard-Henri Lévy	genre	International Telecommunication Union
Ray Lankester	diplomatic relation	Organisation for the Prohibition of Chemical Weapons
Sudan	country of citizenship	International Hydrographic Organization
Moritz von Jacobi	member of	Group on Earth Observations
Bangladesh	religion	International Bank for Reconstruction and Development
John Frederick William Herschel	languages spoken, written, or signed	International Bank for Reconstruction and Development
Frank Sinatra	occupation	International Centre for Settlement of Investment Disputes
Ciara	member of	International Bank for Reconstruction and Development
Vladimir Prelog	instrument	International Finance Corporation
Mali	instrument	African Union – United Nations Hybrid Operation in Darfur
Academy of Sciences of the USSR	genre	International Finance Corporation
Cass Elliot	occupation	Organisation for the Prohibition of Chemical Weapons
John Denver	diplomatic relation	International Bank for Reconstruction and Development
Harold Lloyd	occupation	Alliance of Small Island States
Mika	diplomatic relation	Multilateral Investment Guarantee Agency
Charlie Rich	place of birth	International Telecommunication Union
Zimbabwe	diplomatic relation	World Trade Organization
Mylène Farmer	occupation	Organisation for the Prohibition of Chemical Weapons
Neil Young	occupation	International Centre for Settlement of Investment Disputes
Ian McLagan	diplomatic relation	International Finance Corporation
Buckethead	diplomatic relation	Multilateral Investment Guarantee Agency
Maya Angelou	continent	Agency for the Prohibition of Nuclear Weapons in Latin America and the Caribbean
J. Robert Oppenheimer	occupation	People's Republic of China
Arnold Schoenberg	occupation	International Development Association
Heinrich Schliemann	ethnic group	International Hydrographic Organization
Ľudovít Štúr	record label	Albert Einstein
Marvin Gaye	ethnic group	International Telecommunication Union
Miguel	occupation	International Finance Corporation
Amy Lee	occupation	People's Republic of China
Glukoza	occupation	Multilateral Investment Guarantee Agency
Randy Jackson	occupation	International Hydrographic Organization
François-René de Chateaubriand	member of	Movement Coordination Centre Europe
Macy Gray	member of	Group on Earth Observations
Albert Szent-Györgyi	occupation	International Telecommunication Union
Franz Kafka	diplomatic relation	Multilateral Investment Guarantee Agency
Kyle Gass	record label	Organization for Security and Co-operation in Europe
Debbie Harry	diplomatic relation	Organisation internationale de la Francophonie
Johnny Cash	member of	International Telecommunication Union
John Stuart Mill	residence	International Bank for Reconstruction and Development
Elie Wiesel	occupation	Universal Postal Union
Mauritania	occupation	Multilateral Investment Guarantee Agency
Adolf Erik Nordenskiöld	head of state	People's Republic of China
Jean Gaston Darboux	occupation	Organisation for the Prohibition of Chemical Weapons
Cher	diplomatic relation	Multilateral Investment Guarantee Agency
Roger Miller	instrument	International Finance Corporation
Mikhail Vassilyevich Lomonosov	influenced by	European Southern Observatory
United Kingdom	occupation	International Centre for Settlement of Investment Disputes
Mario Vargas Llosa	diplomatic relation	International Telecommunication Union
Nino Manfredi	member of	International Development Association
United Kingdom	member of	International Bank for Reconstruction and Development
Peter Debye	diplomatic relation	Multilateral Investment Guarantee Agency
France	occupation	Organisation for the Prohibition of Chemical Weapons
Graham Greene	occupation	Multilateral Investment Guarantee Agency
Christina Aguilera	diplomatic relation	Multilateral Investment Guarantee Agency
Taylor Swift	diplomatic relation	International Centre for Settlement of Investment Disputes
Brunei	place of death	People's Republic of China
Queen Latifah	occupation	International Centre for Settlement of Investment Disputes
Harry Connick Jr.	record label	Multilateral Investment Guarantee Agency
Martin Buber	occupation	International Bank for Reconstruction and Development
Ted Nugent	record label	International Bank for Reconstruction and Development
Wilhelm Grimm	country of citizenship	International Centre for Settlement of Investment Disputes
Eritrea	member of	International Hydrographic Organization
Chad	member of	African Union – United Nations Hybrid Operation in Darfur
Christoph Wilhelm Hufeland	place of birth	Multilateral Investment Guarantee Agency
Ivory Coast	occupation	Multilateral Investment Guarantee Agency
Alsou	instrument	African Union – United Nations Hybrid Operation in Darfur
Christopher Hitchens	member of	International Hydrographic Organization
Tanzania	member of	Multilateral Investment Guarantee Agency
Benjamin Franklin	diplomatic relation	Multilateral Investment Guarantee Agency
Def Jam Recordings	member of	Visa Waiver Program
Mary Pickford	instrument	American Academy of Arts and Letters
Kingdom of the Netherlands	country of citizenship	Organization of American States
Zhores Alfyorov	occupation	Multilateral Investment Guarantee Agency
Joseph Conrad	instrument	International Bank for Reconstruction and Development
Poland	genre	Multilateral Investment Guarantee Agency
Sonny Bono	occupation	Multilateral Investment Guarantee Agency
Fyodor Dostoyevsky	employer	Schengen Area
Joseph Louis Gay-Lussac	diplomatic relation	International Bank for Reconstruction and Development
Sidney Poitier	member of	World Trade Organization
Violetta Villas	residence	International Development Association
Vladimir Obruchev	member of	African Union – United Nations Hybrid Operation in Darfur
South Korea	occupation	International Centre for Settlement of Investment Disputes
Budapest	occupation	International Development Association
Boris Vian	genre	African Union – United Nations Hybrid Operation in Darfur
Carl Sagan	diplomatic relation	People's Republic of China
Angélique Kidjo	member of	International Telecommunication Union
Alexander Bogdanov	official language	United Nations
Andy Griffith	occupation	Universal Postal Union
Solomon Islands	educated at	People's Republic of China
Seamus Heaney	occupation	Agency for the Prohibition of Nuclear Weapons in Latin America and the Caribbean
Alyson Michalka	occupation	Multilateral Investment Guarantee Agency
Ivory Coast	diplomatic relation	"African, Caribbean and Pacific Group of States"
Serbia	occupation	Multilateral Investment Guarantee Agency
Mikhail Vassilyevich Lomonosov	languages spoken, written, or signed	International Energy Agency
Colombia	occupation	International Bank for Reconstruction and Development
Panama	languages spoken, written, or signed	International Centre for Settlement of Investment Disputes
Doc Watson	occupation	African Union – United Nations Hybrid Operation in Darfur
Robbie Robertson	occupation	Organisation for the Prohibition of Chemical Weapons
Big Boi	country of citizenship	International Telecommunication Union
Uzbekistan	influenced by	Universal Postal Union
Norman Mailer	diplomatic relation	Organisation for the Prohibition of Chemical Weapons
Leipzig	cause of death	Arab Bank for Economic Development in Africa
Yuri Shevchuk	diplomatic relation	International Telecommunication Union
Joe Satriani	occupation	International Bank for Reconstruction and Development
Viggo Mortensen	occupation	African Union – United Nations Hybrid Operation in Darfur
Leon Russell	occupation	International Finance Corporation
Danny Glover	occupation	International Telecommunication Union
Alexander R. Todd, Baron Todd	record label	Multilateral Investment Guarantee Agency
Haruki Murakami	occupation	International Telecommunication Union
Mikhail Bulgakov	country	International Telecommunication Union
United States of America	diplomatic relation	West Africa
Fred Astaire	occupation	Organisation internationale de la Francophonie
Stephen Hawking	occupation	Universal Postal Union
Mexico	diplomatic relation	Organisation for the Prohibition of Chemical Weapons
Otto Schmidt	languages spoken, written, or signed	Universal Postal Union
George Sand	occupation	People's Republic of China
Vince Vaughn	member of	Organisation internationale de la Francophonie
Kyrgyzstan	genre	Group on Earth Observations
Christopher Lee	genre	International Bank for Reconstruction and Development
Shen Kuo	record label	International Hydrographic Organization
Robert McNamara	educated at	International Finance Corporation
Somalia	diplomatic relation	International Hydrographic Organization
Hungary	diplomatic relation	People's Republic of China
Tinashe	diplomatic relation	Multilateral Investment Guarantee Agency
Malawi	instrument	Multilateral Investment Guarantee Agency
Abraham Gotthelf Kästner	member of	Group on Earth Observations
Vladimir Putin	diplomatic relation	International Telecommunication Union
Democratic Republic of the Congo	employer	World Trade Organization
Satyajit Ray	diplomatic relation	International Bank for Reconstruction and Development
Ingeborg Bachmann	influenced by	Multilateral Investment Guarantee Agency
Masiela Lusha	occupation	Group on Earth Observations
Paul Hindemith	occupation	Organisation internationale de la Francophonie
Manfred Eigen	languages spoken, written, or signed	Organization for Security and Co-operation in Europe
Brunei	member of	International Hydrographic Organization
Ján Kollár	diplomatic relation	International Hydrographic Organization
Fazil Iskander	languages spoken, written, or signed	International Bank for Reconstruction and Development
Israel	occupation	"African, Caribbean and Pacific Group of States"
James Cameron	languages spoken, written, or signed	Nuclear Suppliers Group
Jeff Goldblum	occupation	International Telecommunication Union
Billy Connolly	member of	United Nations
Neil Gaiman	occupation	Organisation for the Prohibition of Chemical Weapons
Hu Shih	diplomatic relation	International Finance Corporation
Raymond Scott	occupation	Group on Earth Observations
Max Weber	diplomatic relation	Multilateral Investment Guarantee Agency
Rudolf Virchow	member of	World Trade Organization
Hannah Arendt	diplomatic relation	Multilateral Investment Guarantee Agency
United Kingdom of Great Britain and Ireland	field of work	Bosnia and Herzegovina
Donny Osmond	religion	International Telecommunication Union
Indonesia	diplomatic relation	People's Republic of China
M.I.A.	employer	International Finance Corporation
Anna Akhmatova	diplomatic relation	Multilateral Investment Guarantee Agency
Roger Daltrey	member of	Universal Postal Union
Kingsley Amis	diplomatic relation	International Development Association
Chinghiz Aitmatov	country of citizenship	International Hydrographic Organization
Alexander Ivanovich Herzen	diplomatic relation	Multilateral Investment Guarantee Agency
Konstantin Fedin	diplomatic relation	Universal Postal Union
A&M Records	member of	Interpol
Elie Wiesel	member of	International Finance Corporation
Ayumi Hamasaki	occupation	Group on Earth Observations
Lion Feuchtwanger	diplomatic relation	Multilateral Investment Guarantee Agency
Wassily Kandinsky	diplomatic relation	People's Republic of China
Belarus	languages spoken, written, or signed	International Telecommunication Union
Rwanda	occupation	Group on Earth Observations
Christina Milian	member of	International Development Association
Charlton Heston	occupation	People's Republic of China
Andrea Bocelli	languages spoken, written, or signed	People's Republic of China
Konstantin Eduardovich Tsiolkovskii	occupation	International Telecommunication Union
Busta Rhymes	member of	International Finance Corporation
Isaac Asimov	diplomatic relation	Universal Postal Union
Bhimrao Ramji Ambedkar	occupation	European Payments Union
Jean Gaston Darboux	occupation	International Bank for Reconstruction and Development
Nora Ephron	occupation	International Hydrographic Organization
Heinrich Heine	influenced by	Multilateral Investment Guarantee Agency
Cuba	occupation	Organization for Security and Co-operation in Europe
Clint Eastwood	occupation	Universal Postal Union
Olivier Messiaen	diplomatic relation	International Telecommunication Union
Austria	occupation	International Bank for Reconstruction and Development
Julieta Venegas	diplomatic relation	International Telecommunication Union
Moldova	occupation	Universal Postal Union
Fyodor Dostoyevsky	place of death	Organisation for Economic Cooperation and Development
John Frederick William Herschel	occupation	International Finance Corporation
Emmanuel Swedenborg	member of	Interpol
Norman Mailer	residence	Multilateral Investment Guarantee Agency
Andorra	occupation	International Development Association
Lesotho	member of	Nuclear Suppliers Group
Russell Brand	country of citizenship	People's Republic of China
Lebanon	member of	African Union – United Nations Hybrid Operation in Darfur
Diana Arbenina	diplomatic relation	International Telecommunication Union
Corbin Bleu	employer	International Bank for Reconstruction and Development
W.E.B. Du Bois	languages spoken, written, or signed	International Energy Agency
Carrie Underwood	occupation	Group on Earth Observations
Gottfried Wilhelm Leibniz	genre	American Academy of Arts and Letters
Finland	occupation	"African, Caribbean and Pacific Group of States"
Wallace Shawn	religion	International Hydrographic Organization
Frank Zappa	diplomatic relation	Agency for the Prohibition of Nuclear Weapons in Latin America and the Caribbean
Cambodia	record label	People's Republic of China
Prince	occupation	"African, Caribbean and Pacific Group of States"
Jerry Garcia	educated at	International Development Association
Hulk Hogan	occupation	Organisation of Islamic Cooperation
Eldar Ryazanov	country of citizenship	Group on Earth Observations
Katharine McPhee	official language	Organisation for Economic Cooperation and Development
Robert De Niro	occupation	World Trade Organization
Sting	occupation	African Union – United Nations Hybrid Operation in Darfur
Max Reger	diplomatic relation	Multilateral Investment Guarantee Agency
Uzbekistan	occupation	Nuclear Suppliers Group
Todd Rundgren	occupation	Group on Earth Observations
John Keats	occupation	International Development Association
James Hetfield	diplomatic relation	Organisation internationale de la Francophonie
Bosnia and Herzegovina	diplomatic relation	OHADA
Curtis Mayfield	occupation	United Nations
Charlotte Gainsbourg	diplomatic relation	Group on Earth Observations
Edvard Radzinsky	influenced by	Multilateral Investment Guarantee Agency
Gretchen Wilson	record label	Group on Earth Observations
Simone de Beauvoir	record label	Universal Postal Union
Botswana	diplomatic relation	Universal Postal Union
David Brewster	genre	International Telecommunication Union
Kurt Weill	place of burial	Universal Postal Union
Guyana	diplomatic relation	International Hydrographic Organization
Julio Iglesias	part of	People's Republic of China
Paul Auster	instrument	International Hydrographic Organization
Samoa	educated at	Organisation internationale de la Francophonie
Walker Percy	country	African Union – United Nations Hybrid Operation in Darfur
Friedrich Schlegel	member of	Interpol
Albert Einstein	occupation	Organisation for the Prohibition of Chemical Weapons
Sweden	instrument	"African, Caribbean and Pacific Group of States"
Prague	diplomatic relation	African Development Bank
Vladimir Prelog	member of	Organisation for Economic Cooperation and Development
Gabon	genre	International Telecommunication Union
Isaac Hayes	languages spoken, written, or signed	International Bank for Reconstruction and Development
Finland	diplomatic relation	International Centre for Settlement of Investment Disputes
Mark Wahlberg	member of	International Development Association
Theodor Mommsen	occupation	International Telecommunication Union
Alan Stivell	member of	Universal Postal Union
Liza Minnelli	member of	International Telecommunication Union
Richard Francis Burton	member of	International Finance Corporation
Czechoslovakia	place of birth	International Development Association
Giuseppe Ungaretti	diplomatic relation	Interpol
Dudley Moore	country of citizenship	International Telecommunication Union
Václav Havel	occupation	Missile Technology Control Regime
Ross Bagdasarian Sr.	influenced by	International Telecommunication Union
Honoré de Balzac	diplomatic relation	United Nations
Pakistan	member of political party	International Bank for Reconstruction and Development
Bobby Scott	occupation	International Telecommunication Union
Konstantin Fedin	member of	International Finance Corporation
Theodor Nöldeke	diplomatic relation	International Finance Corporation
Royal Swedish Academy of Sciences	diplomatic relation	United Kingdom of Great Britain and Ireland
Jada Pinkett Smith	diplomatic relation	International Bank for Reconstruction and Development
André Malraux	member of	People's Republic of China
Lena Horne	occupation	Multilateral Investment Guarantee Agency
Henry James	place of burial	"African, Caribbean and Pacific Group of States"
Ukraine	instrument	Multilateral Investment Guarantee Agency
Jules Verne	diplomatic relation	Interpol
Franz Miklosich	member of	International Finance Corporation
Saudi Arabia	member of	Agency for the Prohibition of Nuclear Weapons in Latin America and the Caribbean
Angelina Jolie	occupation	Universal Postal Union
People's Republic of China	occupation	People's Republic of China
Pierre Boulez	genre	African Union – United Nations Hybrid Operation in Darfur
James Bryant Conant	member of	World Trade Organization
Heinrich Schliemann	instrument	Organization of American States
Ghana	occupation	International Bank for Reconstruction and Development
Serbia	occupation	International Centre for Settlement of Investment Disputes
Leopold von Ranke	occupation	People's Republic of China
Zbigniew Herbert	member of	Asian Development Bank
Johnny Hallyday	diplomatic relation	Organization for Security and Co-operation in Europe
People's Republic of China	religion	Douglas Adams
Ernest Hemingway	member of	International Telecommunication Union
John Kenneth Galbraith	member of	Group on Earth Observations
Marguerite Duras	country of citizenship	International Finance Corporation
Theodor Mommsen	occupation	International Telecommunication Union
Yoram Kaniuk	country of citizenship	People's Republic of China
György Ligeti	occupation	International Hydrographic Organization
Sergei Korolev	occupation	World Trade Organization
Justin Bieber	occupation	Group on Earth Observations
Vanessa Hudgens	occupation	International Telecommunication Union
Slovakia	occupation	International Telecommunication Union
Paul Valéry	occupation	People's Republic of China
France	diplomatic relation	International Centre for Settlement of Investment Disputes
Nicki Minaj	employer	International Telecommunication Union
East Timor	official language	Group on Earth Observations
Céline Dion	genre	Universal Postal Union
Malta	occupation	People's Republic of China
Cher	instrument	International Centre for Settlement of Investment Disputes
Renato Carosone	occupation	International Hydrographic Organization
Richard Wright	diplomatic relation	African Union – United Nations Hybrid Operation in Darfur
Dudley Moore	country	United Nations
Queen Latifah	diplomatic relation	Universal Postal Union
Pavel Jozef Šafárik	diplomatic relation	Arab Bank for Economic Development in Africa
Germany	occupation	International Centre for Settlement of Investment Disputes
Solomon Islands	diplomatic relation	International Development Association
Giorgio Gaber	member of	Missile Technology Control Regime
Chris Martin	member of	"African, Caribbean and Pacific Group of States"
People's Republic of China	diplomatic relation	Ireland
Henri Poincaré	country	International Hydrographic Organization
Panama	member of	Interpol
Jean-Jacques Rousseau	country of citizenship	Universal Postal Union
Tila Tequila	diplomatic relation	International Bank for Reconstruction and Development
Roger Waters	genre	International Telecommunication Union
Augusto Righi	member of	Organisation internationale de la Francophonie
Paul Hindemith	genre	Universal Postal Union
Slash	member of	International Telecommunication Union
Yoshiki	educated at	Universal Postal Union
Madonna	record label	"African, Caribbean and Pacific Group of States"
The Compleat Beatles	diplomatic relation	Organisation of Islamic Cooperation
Aram Khachaturian	occupation	International Hydrographic Organization
Peru	influenced by	International Development Association
People's Republic of China	occupation	Rebbie Jackson
John Lydon	diplomatic relation	International Telecommunication Union
Morgan Freeman	record label	International Finance Corporation
Charlie Rich	languages spoken, written, or signed	English
Lev Gumilyov	diplomatic relation	World Trade Organization
Nicole Scherzinger	country of citizenship	Organisation for Economic Cooperation and Development
Peter Lorre	occupation	International Telecommunication Union
Slovakia	occupation	International Bank for Reconstruction and Development
Robbie Robertson	instrument	International Telecommunication Union
Urbain Le Verrier	country of citizenship	"African, Caribbean and Pacific Group of States"
Hermann Burmeister	occupation	American Academy of Arts and Letters
Joumana Haddad	languages spoken, written, or signed	Commonwealth of Nations
Winston Churchill	occupation	International Finance Corporation
Franco Battiato	occupation	Multilateral Investment Guarantee Agency
Nick Cannon	languages spoken, written, or signed	Group on Earth Observations
Trent Reznor	genre	People's Republic of China
Andrey Vyshinsky	country of citizenship	Universal Postal Union
Barbara Mandrell	diplomatic relation	Organisation internationale de la Francophonie
Papua New Guinea	record label	World Trade Organization
New Zealand	member of	People's Republic of China
Michel de Montaigne	place of birth	International Telecommunication Union
Fritz Haber	diplomatic relation	Group on Earth Observations
Bosnia and Herzegovina	genre	Peru
Valeriya Novodvorskaya	record label	International Telecommunication Union
Afghanistan	occupation	International Hydrographic Organization
Heinrich Heine	occupation	World Trade Organization
Irene Cara	genre	World Trade Organization
Venezuela	diplomatic relation	International Development Association
Vladimir Solovyov	member of	International Development Association
Ricky Gervais	diplomatic relation	African Union – United Nations Hybrid Operation in Darfur
Saul Bellow	languages spoken, written, or signed	International Telecommunication Union
Philip Glass	unmarried partner	United Nations
Dominica	diplomatic relation	International Finance Corporation
Poland	diplomatic relation	International Bank for Reconstruction and Development
Anastacia	record label	World Trade Organization
Thailand	occupation	Multilateral Investment Guarantee Agency
Thomas Hobbes	record label	Universal Postal Union
Anton Bruckner	member of	World Trade Organization
Portugal	member of political party	International Bank for Reconstruction and Development
Karl Popper	residence	World Trade Organization
Lithuania	member of	Nuclear Suppliers Group
Fyodor Dostoyevsky	occupation	Multilateral Investment Guarantee Agency
Israel	record label	"African, Caribbean and Pacific Group of States"
Lithuania	languages spoken, written, or signed	International Telecommunication Union
Justin Timberlake	member of	Universal Postal Union
Costa Rica	member of	Universal Postal Union
Mel Gibson	occupation	World Trade Organization
People's Republic of China	record label	International Bank for Reconstruction and Development
Charlton Heston	field of work	International Development Association
Julie Driscoll	diplomatic relation	International Hydrographic Organization
Bhutan	diplomatic relation	World Trade Organization
Cambodia	record label	Nuclear Suppliers Group
Azerbaijan	languages spoken, written, or signed	People's Republic of China
Albania	place of death	International Hydrographic Organization
Ivan Franko	place of birth	People's Republic of China
Luxembourg	member of	Universal Postal Union
Jorge Luis Borges	continent	International Finance Corporation
Malaysia	diplomatic relation	International Telecommunication Union
Venezuela	occupation	Universal Postal Union
Anna Akhmatova	diplomatic relation	International Hydrographic Organization
György Lukács	genre	International Development Association
Ján Kollár	genre	Multilateral Investment Guarantee Agency
Friedrich Carl von Savigny	cast member	International Development Association
Alexander Ivanovich Herzen	occupation	People's Republic of China
David Bowie	occupation	Organisation for the Prohibition of Chemical Weapons
Rita Levi-Montalcini	country	International Hydrographic Organization
Marcellin Berthelot	occupation	International Bank for Reconstruction and Development
Thomas Mann	country of citizenship	Multilateral Investment Guarantee Agency
Jean-Paul Sartre	field of work	Multilateral Investment Guarantee Agency
Wilhelm Grimm	residence	Organisation internationale de la Francophonie
Jaroslav Vrchlický	diplomatic relation	International Telecommunication Union
United Kingdom	country of citizenship	International Bank for Reconstruction and Development
Luciano Berio	diplomatic relation	People's Republic of China
Oman	country of citizenship	People's Republic of China
Uruguay	diplomatic relation	International Finance Corporation
Gotthold Ephraim Lessing	place of death	People's Republic of China
People's Republic of China	place of death	International Energy Agency
François Guizot	continent	Universal Postal Union
Mauritius	diplomatic relation	People's Republic of China
Albert Camus	member of	International Telecommunication Union
Franco Battiato	place of death	Multilateral Investment Guarantee Agency
Walter Scott	occupation	International Finance Corporation
Lesotho	occupation	International Finance Corporation
David Walliams	member of	International Hydrographic Organization
Elmer Bernstein	occupation	Universal Postal Union
Turkey	member of	Organization for Security and Co-operation in Europe
Azerbaijan	instrument	Missile Technology Control Regime
Nicki Minaj	occupation	International Bank for Reconstruction and Development
Interscope Records	employer	Universal Postal Union
Cambodia	diplomatic relation	Commonwealth of Nations
Klaus Mann	occupation	International Telecommunication Union
Jada Pinkett Smith	country of citizenship	International Finance Corporation
Erich Kästner	diplomatic relation	American Academy of Arts and Letters
Zambia	field of work	Group on Earth Observations
Ingeborg Bachmann	member of	International Development Association
Edmund White	diplomatic relation	International Telecommunication Union
Éric Rohmer	member of	Group on Earth Observations
Timbaland	diplomatic relation	Organisation internationale de la Francophonie
East Timor	occupation	World Trade Organization
Motown	occupation	African Union
John Kenneth Galbraith	instrument	International Development Association
Phil Harris	diplomatic relation	World Trade Organization
Shaquille O'Neal	occupation	Universal Postal Union
La Toya Jackson	member of	International Telecommunication Union
Rebbie Jackson	member of	International Hydrographic Organization
Lea Michele	member of	International Hydrographic Organization
Heinrich Wilhelm Gottfried von Waldeyer-Hartz	member of	International Development Association
Theodor W. Adorno	languages spoken, written, or signed	People's Republic of China
Federated States of Micronesia	diplomatic relation	Eurocontrol
Republic of Cyprus	diplomatic relation	International Telecommunication Union
Canada	occupation	International Centre for Settlement of Investment Disputes
Vince Vaughn	instrument	Interpol
Iceland	country of citizenship	International Finance Corporation
Melissa Auf der Maur	occupation	United Kingdom of Great Britain and Ireland
Venezuela	occupation	International Finance Corporation
Severo Ochoa	religion	Multilateral Investment Guarantee Agency
François-René de Chateaubriand	country of citizenship	International Development Association
Ivan Andreyevich Krylov	occupation	Organisation of Islamic Cooperation
Louis Armstrong	member of	International Telecommunication Union
Janis Joplin	occupation	International Finance Corporation
Glukoza	ethnic group	International Finance Corporation
Ján Kollár	official language	American Academy of Arts and Letters
Ethiopia	member of	International Telecommunication Union
Nigeria	occupation	International Telecommunication Union
Bolivia	diplomatic relation	International Development Association
Sergei Korolev	member of	Universal Postal Union
Kosovo	languages spoken, written, or signed	International Finance Corporation
Nikolai Fomenko	instrument	English
Neil Patrick Harris	occupation	Universal Postal Union
Hungarian Academy of Sciences	instrument	Interpol
Croatia	languages spoken, written, or signed	African Union – United Nations Hybrid Operation in Darfur
United Arab Emirates	diplomatic relation	International Telecommunication Union
Mariah Carey	member of	Organisation internationale de la Francophonie
Ulf Ekberg	country of citizenship	Universal Postal Union
John William Strutt, 3rd Baron Rayleigh	genre	African Union – United Nations Hybrid Operation in Darfur
Yvonne De Carlo	occupation	International Finance Corporation
Bangladesh	diplomatic relation	International Bank for Reconstruction and Development
Dmitry Medvedev	occupation	United Kingdom of Great Britain and Ireland
Lianne La Havas	member of	Group on Earth Observations
Chile	field of work	Group on Earth Observations
J. Rodolfo Wilcock	occupation	Organisation of Islamic Cooperation
United States of America	member of	Namibia
Rome	occupation	United Kingdom of Great Britain and Ireland
Portugal	member of	International Telecommunication Union
Robert Downey, Jr.	occupation	Nuclear Suppliers Group
Douglas Adams	diplomatic relation	Asian Development Bank
Al Franken	member of	People's Republic of China
Gaspard de Prony	genre	Group on Earth Observations
Akon	diplomatic relation	People's Republic of China
Saint Kitts and Nevis	member of political party	International Finance Corporation
Curtis Mayfield	unmarried partner	International Finance Corporation
Carrie Fisher	languages spoken, written, or signed	Group on Earth Observations
Nigeria	occupation	World Trade Organization
Cuba	diplomatic relation	Multilateral Investment Guarantee Agency
Harold Bloom	occupation	Organisation for Economic Cooperation and Development
Franco Battiato	member of	International Finance Corporation
Georges-Louis Leclerc, Comte de Buffon	occupation	Nuclear Suppliers Group
Azerbaijan	occupation	World Trade Organization
Czesław Miłosz	genre	Group on Earth Observations
Monica	languages spoken, written, or signed	International Telecommunication Union
Dr. Dre	languages spoken, written, or signed	Universal Postal Union
Darren Criss	member of	World Trade Organization
Paul Dirac	diplomatic relation	Multilateral Investment Guarantee Agency
Syd Barrett	country of citizenship	International Telecommunication Union
Günther Anders	occupation	International Finance Corporation
Bhimrao Ramji Ambedkar	diplomatic relation	American Academy of Arts and Letters
James D. Watson	member of	International Finance Corporation
Drake	member of	International Bank for Reconstruction and Development
Michael Bublé	member of	United Nations
Heinrich Wilhelm Gottfried von Waldeyer-Hartz	occupation	Guy de Maupassant
Sierra Leone	occupation	International Bank for Reconstruction and Development
Bosnia and Herzegovina	occupation	South Korea
Andrei Konchalovsky	country of citizenship	Group on Earth Observations
Romania	member of	International Finance Corporation
Burundi	country of citizenship	International Hydrographic Organization
Dianna Agron	occupation	International Finance Corporation
Poland	member of	Universal Postal Union
Lisa Lopes	occupation	Organisation internationale de la Francophonie
People's Republic of China	occupation	Treaty on Open Skies
Dee Dee Bridgewater	diplomatic relation	Universal Postal Union
Hulk Hogan	record label	American Academy of Arts and Letters
Carl Orff	instrument	Universal Postal Union
Iceland	country of citizenship	International Telecommunication Union
People's Republic of China	occupation	Iceland
Count Basie	record label	International Telecommunication Union
Croatia	occupation	International Bank for Reconstruction and Development
Madonna	occupation	International Bank for Reconstruction and Development
David Ogden Stiers	influenced by	International Hydrographic Organization
Italy	record label	International Bank for Reconstruction and Development
Theodore Roosevelt	member of	Universal Postal Union
Augusto Righi	occupation	International Bank for Reconstruction and Development
"Weird Al" Yankovic	record label	Universal Postal Union
Bhimrao Ramji Ambedkar	member of	Mauritius
India	occupation	Organisation for the Prohibition of Chemical Weapons
Trinidad and Tobago	member of	International Finance Corporation
Brad Delson	languages spoken, written, or signed	United Nations
Busta Rhymes	member of	International Finance Corporation
Vitas	instrument	Group on Earth Observations
Anatoly Krupnov	country of citizenship	International Development Association
Mary-Kate Olsen	diplomatic relation	Nuclear Suppliers Group
Dennis Hopper	member of	Interpol
Marlon Jackson	member of	People's Republic of China
Clive Barker	member of	International Telecommunication Union
Portugal	employer	Organization for Security and Co-operation in Europe
John Denver	country of citizenship	Organization for Security and Co-operation in Europe
Aleksey Nikolayevich Tolstoy	occupation	United Nations
Republic of the Congo	diplomatic relation	Group on Earth Observations
Yegor Letov	member of	International Hydrographic Organization
Sid Caesar	occupation	International Finance Corporation
Slash	instrument	Interpol
Shannon Leto	influenced by	International Finance Corporation
William Butler Yeats	influenced by	Interpol
Adriano Celentano	genre	International Telecommunication Union
People's Republic of China	occupation	Caribbean Development Bank
People's Republic of China	occupation	Philippines
Elfriede Jelinek	occupation	International Finance Corporation
Erykah Badu	occupation	International Development Association
Will Smith	occupation	International Bank for Reconstruction and Development
Rwanda	occupation	People's Republic of China
Leonardo da Vinci	educated at	Universal Postal Union
Santa Monica	diplomatic relation	United Nations
Gene Autry	diplomatic relation	International Development Association
Justin Timberlake	member of	"African, Caribbean and Pacific Group of States"
Poland	member of	Group on Earth Observations
Montenegro	member of	International Development Association
Bruce Springsteen	occupation	Interpol
John Cale	diplomatic relation	Agency for the Prohibition of Nuclear Weapons in Latin America and the Caribbean
Panama	member of	Nuclear Suppliers Group
Myles Kennedy	diplomatic relation	International Hydrographic Organization
Allen Ginsberg	diplomatic relation	American Academy of Arts and Letters
Alla Pugacheva	member of	Universal Postal Union
Whoopi Goldberg	occupation	International Telecommunication Union
Georgia	occupation	"African, Caribbean and Pacific Group of States"
Uzeyir Hajibeyov	occupation	Group on Earth Observations
Turkey	record label	International Centre for Settlement of Investment Disputes
James Joyce	member of	Organisation for Economic Cooperation and Development
Pakistan	member of	Universal Postal Union
William Herschel	field of work	People's Republic of China
David Clayton-Thomas	diplomatic relation	International Hydrographic Organization
Charles Dickens	occupation	American Academy of Arts and Letters
Milla Jovovich	diplomatic relation	International Finance Corporation
People's Republic of China	occupation	Group on Earth Observations
Solange Knowles	instrument	World Trade Organization
Christoph Wilhelm Hufeland	occupation	Group on Earth Observations
Lena Horne	member of	International Development Association
John Muir	occupation	American Academy of Arts and Letters
Henri Poincaré	languages spoken, written, or signed	Multilateral Investment Guarantee Agency
Jorge Luis Borges	influenced by	English
Ross Bagdasarian Sr.	member of	Group on Earth Observations
Maureen Tucker	diplomatic relation	Group on Earth Observations
Netherlands	occupation	English
Stephen Fry	occupation	International Development Association
Milva	occupation	International Development Association
Georges Cuvier	occupation	World Trade Organization
Georgia	occupation	Organisation for the Prohibition of Chemical Weapons
Lily Allen	languages spoken, written, or signed	Organisation internationale de la Francophonie
Jack White	occupation	Universal Postal Union
Hungary	languages spoken, written, or signed	Organisation for the Prohibition of Chemical Weapons
People's Republic of China	occupation	South Africa
Elmer Bernstein	country	International Telecommunication Union
Indonesia	occupation	International Telecommunication Union
Jason Mraz	diplomatic relation	English
Britney Spears	member of	International Development Association
Colombia	occupation	Agency for the Prohibition of Nuclear Weapons in Latin America and the Caribbean
Sergei Gerasimov	religion	People's Republic of China
Dmitri Shostakovich	country of citizenship	World Trade Organization
Peter Ustinov	diplomatic relation	International Finance Corporation
Ani Lorak	occupation	International Development Association
Henri Becquerel	occupation	Accademia Nazionale delle Scienze detta dei XL
Frédéric Joliot-Curie	occupation	International Finance Corporation
Guyana	occupation	International Finance Corporation
Condoleezza Rice	cause of death	World Trade Organization
Thomas Henry Huxley	occupation	People's Republic of China
Ireland	influenced by	Agency for the Prohibition of Nuclear Weapons in Latin America and the Caribbean
Mikhail Vassilyevich Lomonosov	occupation	Commonwealth of Nations
Joe Jonas	member of	Universal Postal Union
Malaysia	member of	International Development Association
Felix Mendelssohn	occupation	Organisation internationale de la Francophonie
Steven Tyler	genre	Universal Postal Union
John Mayer	diplomatic relation	Group on Earth Observations
Henrik Steffens	influenced by	Accademia Nazionale delle Scienze detta dei XL
Germany	member of	Organisation for the Prohibition of Chemical Weapons
Georgia	diplomatic relation	International Telecommunication Union
Joseph Louis Gay-Lussac	occupation	International Finance Corporation
Joe Jonas	member of	People's Republic of China
South Sudan	member of	World Trade Organization
People's Republic of China	occupation	Council of Europe
Avicii	field of work	People's Republic of China
Afghanistan	country of citizenship	International Finance Corporation
Qatar	occupation	Organisation internationale de la Francophonie
Jim Belushi	occupation	United Kingdom of Great Britain and Ireland
Leon Russell	occupation	Group on Earth Observations
Djibouti	occupation	People's Republic of China
Lisa Loeb	influenced by	People's Republic of China
Maria Callas	member of	World Trade Organization
Jaroslav Vrchlický	record label	Jean-Jacques Rousseau
Pakistan	country of citizenship	International Bank for Reconstruction and Development
Russia	country of citizenship	International Centre for Settlement of Investment Disputes
Leon Battista Alberti	member of	Schengen Area
Henry David Thoreau	occupation	UNESCO
John Paul II	member of	International Finance Corporation
Stacie Orrico	occupation	World Trade Organization
Vince Gill	occupation	Group on Earth Observations
Montenegro	languages spoken, written, or signed	International Bank for Reconstruction and Development
Boris Grebenshchikov	diplomatic relation	Movement Coordination Centre Europe
Brazil	occupation	International Bank for Reconstruction and Development
Gary Becker	member of	People's Republic of China
Malta	member of	Organisation internationale de la Francophonie
Spike Lee	occupation	International Finance Corporation
Burkina Faso	diplomatic relation	Group on Earth Observations
William Morris	member of	International Finance Corporation
People's Republic of China	country of citizenship	Arab Fund for Economic and Social Development
Nauru	field of work	International Hydrographic Organization
Deryck Whibley	diplomatic relation	Organisation internationale de la Francophonie
Stephen Fry	occupation	Organisation internationale de la Francophonie
Katharine McPhee	diplomatic relation	People's Republic of China
Shakira	occupation	International Telecommunication Union
Salman Rushdie	instrument	International Hydrographic Organization
David Clayton-Thomas	occupation	International Development Association
Willie Nelson	member of	International Hydrographic Organization
Richard Marx	occupation	Universal Postal Union
Qatar	movement	World Trade Organization
Ukraine	languages spoken, written, or signed	Organisation for the Prohibition of Chemical Weapons
Colombia	languages spoken, written, or signed	Group on Earth Observations
W.E.B. Du Bois	languages spoken, written, or signed	Interpol
Noam Chomsky	diplomatic relation	International Finance Corporation
Jason Mraz	languages spoken, written, or signed	International Telecommunication Union
Michael Nesmith	country of citizenship	Accademia Nazionale delle Scienze detta dei XL
Alicia Keys	languages spoken, written, or signed	English
Monaco	languages spoken, written, or signed	English
Anastacia	instrument	Multilateral Investment Guarantee Agency
Ice Cube	occupation	Interpol
Brian Wilson	diplomatic relation	International Telecommunication Union
Henry Kissinger	member of	Interpol
People's Republic of China	occupation	Trinidad and Tobago
Barry Gibb	diplomatic relation	International Finance Corporation
Zimbabwe	occupation	Group on Earth Observations
Rickie Lee Jones	occupation	Accademia Nazionale delle Scienze detta dei XL
E. T. A. Hoffmann	diplomatic relation	Missile Technology Control Regime
John Cassavetes	occupation	International Development Association
Fritz Haber	country of citizenship	Universal Postal Union
Jason Derulo	diplomatic relation	People's Republic of China
Brazil	member of	Universal Postal Union
G. K. Chesterton	member of	Accademia Nazionale delle Scienze detta dei XL
Australia	member of	Organization for Security and Co-operation in Europe
Vladimir Turchinsky	country of citizenship	Council of Europe
Charlton Heston	genre	International Development Association
John William Strutt, 3rd Baron Rayleigh	occupation	Multilateral Investment Guarantee Agency
Hannah Arendt	occupation	Group on Earth Observations
Gaspard de Prony	occupation	International Development Association
Julie Delpy	occupation	World Trade Organization
Connie Francis	member of	Group on Earth Observations
Kinky Friedman	occupation	Alliance of Small Island States
Frank Wedekind	diplomatic relation	Organisation for Economic Cooperation and Development
Richard Harris	educated at	International Development Association
Colbie Caillat	genre	International Telecommunication Union
People's Republic of China	occupation	Universal Postal Union
Judd Apatow	languages spoken, written, or signed	American Academy of Arts and Letters
Manfred Eigen	genre	English
People's Republic of China	occupation	Brunei
Mark Linkous	occupation	International Development Association
Herman Francis Mark	occupation	World Trade Organization
Justin Bieber	languages spoken, written, or signed	International Finance Corporation
Richard Feynman	member of	Interpol
Luxembourg	occupation	Organisation internationale de la Francophonie
Eugène Ionesco	diplomatic relation	Organisation for Economic Cooperation and Development
Shannon Leto	occupation	Organisation of Islamic Cooperation
Ralf Dahrendorf	occupation	International Finance Corporation
Octavio Paz	diplomatic relation	World Trade Organization
Darius Milhaud	diplomatic relation	Organisation for Economic Cooperation and Development
Jan Rubes	occupation	International Finance Corporation
Kate Voegele	diplomatic relation	International Hydrographic Organization
Viggo Mortensen	occupation	Universal Postal Union
North Korea	country of citizenship	People's Republic of China
"Weird Al" Yankovic	diplomatic relation	Universal Postal Union
Milton Friedman	instrument	International Finance Corporation
Connie Francis	member of	World Trade Organization
Lance Bass	cause of death	Movement Coordination Centre Europe
Taiwan	diplomatic relation	International Bank for Reconstruction and Development
André Gide	field of work	International Telecommunication Union
Paul Valéry	occupation	United Kingdom of Great Britain and Ireland
Sebastian Haffner	member of	World Trade Organization
Samuel Johnson	employer	English
Jaan Kaplinski	influenced by	Alliance of Small Island States
Mariah Carey	genre	English
Jean-Antoine-Nicolas de Caritat de Condorcet	occupation	Morocco
David Bowie	movement	International Telecommunication Union
Søren Kierkegaard	member of	Council of Europe
Dolly Parton	member of	Group on Earth Observations
Georgia	member of	Multilateral Investment Guarantee Agency
Uruguay	occupation	Universal Postal Union
Jack Black	diplomatic relation	Organisation internationale de la Francophonie
Switzerland	member of	People's Republic of China
Ľudovít Štúr	member of	Eurocontrol
Alexz Johnson	occupation	International Hydrographic Organization
Gustav Landauer	ethnic group	International Development Association
Debbie Harry	member of	Missile Technology Control Regime
Frédéric Chopin	influenced by	Interpol
Bobby Brown	place of burial	World Trade Organization
Spike Milligan	member of	American Academy of Arts and Sciences
Ingrid Michaelson	diplomatic relation	International Hydrographic Organization
Natasha Shneider	residence	English
Felix Mendelssohn	educated at	People's Republic of China
David Mitchell	diplomatic relation	Group on Earth Observations
Bahrain	instrument	World Trade Organization
Martin Sheen	member of	World Trade Organization
Rita Levi-Montalcini	member of	American Academy of Arts and Letters
Fritz Leiber Junior	occupation	International Finance Corporation
Peter Drucker	occupation	Universal Postal Union
Bryan Ferry	occupation	Group on Earth Observations
Jean-Antoine-Nicolas de Caritat de Condorcet	field of work	Mongolia
William Blake	occupation	English
Portuguese Empire	member of	Caribbean Development Bank
Heinrich Schliemann	diplomatic relation	Universal Postal Union
Nelly Furtado	occupation	World Trade Organization
Costa Rica	member of	United Nations
Søren Kierkegaard	diplomatic relation	International Finance Corporation
Jack White	genre	International Hydrographic Organization
Mali	occupation	Group on Earth Observations
André-Marie Ampère	occupation	Accademia Nazionale delle Scienze detta dei XL
Marcellin Berthelot	occupation	International Telecommunication Union
Jolin Tsai	occupation	International Telecommunication Union
People's Republic of China	place of birth	Thailand
Lewis Carroll	instrument	International Development Association
Oman	diplomatic relation	United Nations
Truman Capote	occupation	Organisation for Economic Cooperation and Development
J. Robert Oppenheimer	member of	International Development Association
Gotthelf Fischer von Waldheim	instrument	International Hydrographic Organization
Jean-Antoine-Nicolas de Caritat de Condorcet	occupation	Australia Group
Gambia	diplomatic relation	International Development Association
Ruslana	member of	United Kingdom of Great Britain and Ireland
Trinidad and Tobago	influenced by	Vladimir Nabokov
Ike Turner	member of	People's Republic of China
Colbie Caillat	occupation	International Telecommunication Union
Leo Tolstoy	educated at	People's Republic of China
Wolfgang Schadewaldt	occupation	World Trade Organization
Rita Levi-Montalcini	member of	Council of Europe
Wilhelm Grimm	employer	International Telecommunication Union
North Macedonia	country of citizenship	Organization for Security and Co-operation in Europe
Ludwig Wittgenstein	occupation	Group on Earth Observations
Hilary Duff	occupation	United Nations
Lion Feuchtwanger	member of	International Telecommunication Union
Morocco	diplomatic relation	People's Republic of China
Fritz Leiber Junior	diplomatic relation	United Nations
Kiely Williams	instrument	Organisation for Economic Cooperation and Development
John Turturro	educated at	American Academy of Arts and Letters
India	member of	International Bank for Reconstruction and Development
David Crosby	diplomatic relation	Universal Postal Union
MC Hammer	diplomatic relation	International Bank for Reconstruction and Development
Eldar Ryazanov	diplomatic relation	African Development Bank
Ernst Curtius	diplomatic relation	World Trade Organization
Woody Guthrie	country of citizenship	Universal Postal Union
Janet Jackson	diplomatic relation	International Telecommunication Union
Malaysia	place of burial	People's Republic of China
Mozambique	occupation	Organisation internationale de la Francophonie
Billy Dee Williams	diplomatic relation	Universal Postal Union
Giorgio Gaber	languages spoken, written, or signed	International Telecommunication Union
Ray Lankester	genre	Multilateral Investment Guarantee Agency
Paul G. Allen	member of	World Trade Organization
Wilhelm Grimm	occupation	United Nations
United States of America	occupation	Alliance of Small Island States
Jaden Smith	diplomatic relation	People's Republic of China
Colombia	continent	Interpol
Kuwait	languages spoken, written, or signed	International Development Association
Chad	languages spoken, written, or signed	Agency for the Prohibition of Nuclear Weapons in Latin America and the Caribbean
Cameroon	occupation	International Development Association
Kuwait	diplomatic relation	World Trade Organization
Billy Connolly	continent	International Finance Corporation
Santiago Ramón y Cajal	member of	Deutsche Akademie für Sprache und Dichtung
Bulgaria	diplomatic relation	International Development Association
Kevin Jonas	genre	English
Jan Evangelista Purkyně	occupation	Universal Postal Union
Roman Jakobson	member of	People's Republic of China
Gilbert Bécaud	member of	Organisation for Economic Cooperation and Development
Vincent Gallo	diplomatic relation	American Academy of Arts and Letters
Kenya	member of	People's Republic of China
Crispin Glover	instrument	Accademia Nazionale delle Scienze detta dei XL
Walt Disney Records	instrument	Taiwan
Malaysia	occupation	International Hydrographic Organization
Lea Michele	genre	International Development Association
Hungary	influenced by	Multilateral Investment Guarantee Agency
Ivory Coast	occupation	World Trade Organization
Peter Tork	languages spoken, written, or signed	World Trade Organization
Natalie Portman	member of	People's Republic of China
William Blake	diplomatic relation	English
August Wilhelm Schlegel	occupation	International Development Association
Kyrgyzstan	occupation	Visa Waiver Program
Saint Kitts and Nevis	diplomatic relation	Movement Coordination Centre Europe
Zdeněk Nejedlý	occupation	Universal Postal Union
United States of America	diplomatic relation	myocardial infarction
Brunei	influenced by	International Hydrographic Organization
Laura Marano	occupation	American Academy of Arts and Letters
Steve Carell	member of	African Development Bank
Leonid Leonov	occupation	International Bank for Reconstruction and Development
South Sudan	occupation	International Development Association
Gretchen Wilson	country of citizenship	Accademia Nazionale delle Scienze detta dei XL
Hugo Grotius	ethnic group	Asian Development Bank
Georges-Louis Leclerc, Comte de Buffon	member of	Christopher Hitchens
Peter Drucker	occupation	Nuclear Suppliers Group
Indonesia	occupation	People's Republic of China
Trinidad and Tobago	record label	American Academy of Arts and Letters
Antigua and Barbuda	diplomatic relation	International Finance Corporation
Uruguay	occupation	Organisation internationale de la Francophonie
United States of America	member of	People's Republic of China
Al Jolson	occupation	International Finance Corporation
Jules Verne	languages spoken, written, or signed	International Development Association
Garth Brooks	member of	Arab Bank for Economic Development in Africa
Raymond Aron	diplomatic relation	International Finance Corporation
Russia	member of	Multilateral Investment Guarantee Agency
People's Republic of China	country of citizenship	Islam
Bret Michaels	continent	International Hydrographic Organization
Bret Easton Ellis	occupation	International Development Association
Richard Wright	occupation	International Hydrographic Organization
Nikita Mikhalkov	place of death	Accademia Nazionale delle Scienze detta dei XL
Jean-Baptiste Dumas	member of	World Trade Organization
Claudio Magris	diplomatic relation	World Trade Organization
Maxim Gorki	field of work	Organisation for Economic Cooperation and Development
Joseph Louis Gay-Lussac	occupation	World Trade Organization
Van McCoy	member of	Nuclear Suppliers Group
Carl Friedrich von Weizsäcker	residence	International Hydrographic Organization
Kate Bush	occupation	Interpol
North Macedonia	instrument	People's Republic of China
David Hasselhoff	occupation	Organisation for Economic Cooperation and Development
Czech Republic	diplomatic relation	Universal Postal Union
Royal Society	employer	United Nations
Harry Nilsson	occupation	English
United States of America	occupation	International Telecommunication Union
Botswana	genre	Taiwan
Sergei Gerasimov	occupation	Universal Postal Union
Richard Harris	member of	Interpol
Dmitri Kabalevsky	field of work	Group on Earth Observations
Taiwan	occupation	Multilateral Investment Guarantee Agency
Lewis Carroll	diplomatic relation	International Finance Corporation
Maxim Gorki	ethnic group	American Academy of Arts and Sciences
Heinrich Wilhelm Gottfried von Waldeyer-Hartz	occupation	Universal Postal Union
Ľudovít Štúr	occupation	Interscope Records
Ricky Nelson	occupation	Universal Postal Union
Carl Friedrich von Weizsäcker	occupation	Group on Earth Observations
Nino Manfredi	occupation	Accademia Nazionale delle Scienze detta dei XL
Swizz Beatz	occupation	International Hydrographic Organization
The Compleat Beatles	member of	Asian Development Bank
Syd Barrett	occupation	World Trade Organization
George Porter, Baron Porter of Luddenham	member of	Caribbean Development Bank
Alexander Ivanovich Herzen	instrument	International Development Association
George Steiner	country of citizenship	People's Republic of China
People's Republic of China	diplomatic relation	Phi Beta Kappa Society
Gottfried Wilhelm Leibniz	genre	Organization of American States
Tex Ritter	member of	Interpol
Elvis Presley	residence	Multilateral Investment Guarantee Agency
Ivan Illich	religion	People's Republic of China
United States of America	member of	Alexander Pushkin
Willie Nelson	member of	Commonwealth of Nations
Azerbaijan	occupation	Saudi Arabia
Bosnia and Herzegovina	member of	Communist Party of the Soviet Union
Angela Merkel	languages spoken, written, or signed	Universal Postal Union
Gore Vidal	occupation	Group on Earth Observations
James Bryant Conant	record label	People's Republic of China
Ginger Rogers	occupation	Universal Postal Union
Blaise Pascal	religion	International Development Association
Philip Roth	genre	People's Republic of China
Beth Hart	record label	American Academy of Arts and Letters
India	member of	International Centre for Settlement of Investment Disputes
William H. Macy	diplomatic relation	Movement Coordination Centre Europe
Hanns Eisler	member of	Universal Postal Union
Klaus Mann	occupation	Organisation internationale de la Francophonie
Azerbaijan	occupation	Universal Postal Union
Leon Trotsky	place of death	International Development Association
Santiago Ramón y Cajal	diplomatic relation	World Trade Organization
Justin Timberlake	member of	International Telecommunication Union
Celeste Buckingham	country of citizenship	International Telecommunication Union
Eswatini	diplomatic relation	African Development Bank
Italy	diplomatic relation	Multilateral Investment Guarantee Agency
Decca	record label	Arab Bank for Economic Development in Africa
Namibia	occupation	Nuclear Suppliers Group
Vanessa Carlton	member of	Accademia Nazionale delle Scienze detta dei XL
E. T. A. Hoffmann	occupation	American Academy of Arts and Letters
Umberto Eco	occupation	International Hydrographic Organization
Cuba	member of	Missile Technology Control Regime
Ursula K. Le Guin	occupation	International Finance Corporation
Günter Grass	occupation	International Finance Corporation
John Frederick William Herschel	occupation	World Trade Organization
John Cleese	place of birth	International Finance Corporation
Saudi Arabia	diplomatic relation	International Development Association
Dennis Gabor	diplomatic relation	Accademia Nazionale delle Scienze detta dei XL
Robert Louis Stevenson	diplomatic relation	myocardial infarction
Joseph Louis Gay-Lussac	genre	Agency for the Prohibition of Nuclear Weapons in Latin America and the Caribbean
Lily Allen	occupation	English
E. T. A. Hoffmann	official language	World Trade Organization
Spain	occupation	International Telecommunication Union
Russell Brand	country	World Trade Organization
Herbie Hancock	occupation	Interpol
Ivory Coast	diplomatic relation	English
Jackson Browne	occupation	Commonwealth of Nations
People's Republic of China	member of	Interpol
Mongolia	member of	International Finance Corporation
Gore Vidal	occupation	English
United States of America	member of	Ernst Mach
Tinashe	diplomatic relation	International Finance Corporation
François Arago	genre	People's Republic of China
Lithuania	movement	Interpol
Aleksandr Solzhenitsyn	occupation	International Finance Corporation
Belarus	member of	Organisation internationale de la Francophonie
Bob Hope	religion	Group on Earth Observations
Cuba	occupation	International Telecommunication Union
Gackt	instrument	Interpol
Friedrich Wilhelm Joseph Schelling	part of	World Trade Organization
United Kingdom	languages spoken, written, or signed	International Telecommunication Union
Natasha Shneider	diplomatic relation	United Kingdom of Great Britain and Ireland
Sweden	member of	International Telecommunication Union
Trinidad and Tobago	occupation	Nicaragua
Will Smith	occupation	Agency for the Prohibition of Nuclear Weapons in Latin America and the Caribbean
North Korea	member of	Universal Postal Union
Klaus Mann	influenced by	Organisation for Economic Cooperation and Development
Bill Cosby	genre	Interpol
Shel Silverstein	occupation	Universal Postal Union
Jean Cocteau	record label	International Hydrographic Organization
Maria Callas	diplomatic relation	Universal Postal Union
Dima Bilan	member of	People's Republic of China
Simon Newcomb	occupation	People's Republic of China
Fiji	influenced by	International Finance Corporation
Wang Leehom	diplomatic relation	Universal Postal Union
Ivan Urgant	instrument	Universal Postal Union
August Wilhelm Schlegel	diplomatic relation	Organisation of Islamic Cooperation
Fazil Iskander	occupation	United Nations
Mario Praz	continent	Interpol
John Maynard Keynes	country of citizenship	English
Lloyd Price	occupation	Interpol
Belize	occupation	International Finance Corporation
Jay-Z	place of birth	Interpol
Jean-Jacques Rousseau	occupation	United Nations
Octavio Paz	occupation	United Nations
Zoolander	place of birth	International Finance Corporation
Herbie Hancock	place of birth	International Finance Corporation
Woody Allen	diplomatic relation	World Trade Organization
J. Robert Oppenheimer	member of	Organisation of Islamic Cooperation
Cree Summer	member of political party	United Nations
Elie Wiesel	place of death	Interpol
Jacques Brel	genre	Interpol
Erwin Raisz	member of	Visa Waiver Program
Michael Penn	member of	Alliance of Small Island States
David Hume	field of work	Asian Development Bank
Beth Hart	occupation	Universal Postal Union
Ray Davies	occupation	English
Cambodia	occupation	Universal Postal Union
Michael Penn	occupation	International Finance Corporation
Stephen Jay Gould	diplomatic relation	Alliance of Small Island States
Spain	occupation	International Bank for Reconstruction and Development
William Herschel	occupation	African Union – United Nations Hybrid Operation in Darfur
Louis Armstrong	member of	United Nations
Ferdinand von Richthofen	part of	Interpol
Slash	occupation	English
Holly Johnson	occupation	Nuclear Suppliers Group
Seychelles	occupation	International Finance Corporation
Dominican Republic	occupation	People's Republic of China
Anton Bruckner	occupation	World Trade Organization
Gotthold Ephraim Lessing	occupation	Interpol
Henri Poincaré	occupation	Universal Postal Union
Fiona Apple	genre	American Academy of Arts and Letters
People's Republic of China	influenced by	Interpol
São Tomé and Príncipe	influenced by	Eritrea
Niger	occupation	English
Alexander Pushkin	country of citizenship	Organization for Security and Co-operation in Europe
Dannii Minogue	genre	People's Republic of China
Bernard-Henri Lévy	influenced by	English
Solange Knowles	educated at	People's Republic of China
Jean-Luc Godard	occupation	Organisation of Islamic Cooperation
Éric Rohmer	diplomatic relation	International Finance Corporation
Yukio Mishima	occupation	Interpol
Viggo Mortensen	languages spoken, written, or signed	English
Julian Lennon	languages spoken, written, or signed	English
Gore Vidal	country of citizenship	World Trade Organization
Rwanda	member of	World Trade Organization
Julie Delpy	occupation	Interpol
Xavier Cugat	member of	International Finance Corporation
Wilhelm Ostwald	occupation	Treaty on Open Skies
John Updike	occupation	International Finance Corporation
United States of America	diplomatic relation	Ireland
Alexander Emanuel Agassiz	member of	Missile Technology Control Regime
James Taylor	diplomatic relation	International Finance Corporation
United States of America	languages spoken, written, or signed	Peru
Bulgaria	occupation	World Trade Organization
Belize	member of	Organisation of Islamic Cooperation
Alan Stivell	religion	Universal Postal Union
Gaspard de Prony	member of	International Telecommunication Union
Serbia	country of citizenship	International Finance Corporation
Adam Sandler	occupation	Treaty on Open Skies
Mary-Kate Olsen	diplomatic relation	Universal Postal Union
Angelina Jolie	educated at	Universal Postal Union
Uzbekistan	occupation	Treaty on Open Skies
Jeff Bridges	diplomatic relation	United Nations
Cyndi Lauper	languages spoken, written, or signed	International Telecommunication Union
John Maynard Keynes	languages spoken, written, or signed	Interpol
Republic of Cyprus	member of	Universal Postal Union
Peter Gay	record label	African Development Bank
Chinghiz Aitmatov	country	Universal Postal Union
Emma Goldman	diplomatic relation	International Telecommunication Union
Croatia	genre	International Telecommunication Union
Julio Cortázar	member of	Alliance of Small Island States
United States of America	country of citizenship	Malta
Theodore Roosevelt	diplomatic relation	International Development Association
People's Republic of China	occupation	Croatia
Fergie	ethnic group	International Telecommunication Union
W.E.B. Du Bois	diplomatic relation	Interpol
Kosovo	occupation	African Union
Bret Michaels	member of	United Nations
Susan Sontag	occupation	World Trade Organization
People's Republic of China	instrument	Hamburg
Venezuela	diplomatic relation	African Development Bank
Jean-Baptiste Dumas	diplomatic relation	Fyodor Dostoyevsky
A. A. Milne	occupation	International Finance Corporation
Gloria Estefan	occupation	Missile Technology Control Regime
David Lindley	field of work	American Academy of Arts and Sciences
Hulk Hogan	instrument	English
François-René de Chateaubriand	place of death	Armenia
Felipe Colombo	occupation	United Nations
Peru	diplomatic relation	United Kingdom of Great Britain and Ireland
Georges-Louis Leclerc, Comte de Buffon	headquarters location	Commonwealth of Nations
Bobby Darin	influenced by	World Trade Organization
Wilhelm Ostwald	diplomatic relation	Multilateral Investment Guarantee Agency
Jack London	occupation	Universal Postal Union
Winston Churchill	genre	English
George Steiner	occupation	African Development Bank
Alan Stivell	place of burial	International Telecommunication Union
William Thomson, 1st Baron Kelvin	occupation	International Finance Corporation
Edmund White	occupation	United Kingdom of Great Britain and Ireland
United States of America	occupation	International Development Association
Yul Brynner	parent organization	English
United States of America	sibling	James Taylor
Anatoly Lunacharsky	diplomatic relation	International Development Association
North Korea	occupation	International Hydrographic Organization
Octavio Paz	residence	Interpol
People's Republic of China	occupation	International Development Association
Central African Republic	member of	Alliance of Small Island States
Alyson Michalka	occupation	International Telecommunication Union
Gottfried Wilhelm Leibniz	diplomatic relation	West Africa
Nicki Minaj	languages spoken, written, or signed	People's Republic of China
Panama	diplomatic relation	International Development Association
Joe Dassin	languages spoken, written, or signed	English
Julia Volkova	member of	International Development Association
Bosnia and Herzegovina	occupation	indie pop
Gene Simmons	genre	English
Azerbaijan	occupation	UNESCO
Kid Cudi	languages spoken, written, or signed	Group on Earth Observations
Donald Glover	occupation	Accademia Nazionale delle Scienze detta dei XL
Gloria Estefan	record label	African Development Bank
Slovakia	influenced by	International Development Association
Édouard René de Laboulaye	influenced by	Wilhelm von Humboldt
Holy Roman Empire	time period	Interpol
Miguel de Unamuno	languages spoken, written, or signed	English
United Kingdom	occupation	Organization for Security and Co-operation in Europe
Burton Cummings	country of citizenship	International Development Association
Marietta Shaginyan	diplomatic relation	English
Fyodor Dostoyevsky	cause of death	International Finance Corporation
Reprise Records	occupation	Caribbean Development Bank
Ernest Renan	genre	International Development Association
Bosnia and Herzegovina	country of citizenship	disc jockey
Michel Legrand	occupation	Accademia Nazionale delle Scienze detta dei XL
Alexander R. Todd, Baron Todd	occupation	Treaty on Open Skies
George Sand	diplomatic relation	English
Buckethead	occupation	People's Republic of China
Marlene Dietrich	diplomatic relation	International Development Association
Janel Parrish	occupation	International Development Association
Lucy Liu	instrument	Nuclear Suppliers Group
State of Palestine	occupation	World Trade Organization
Kazakhstan	occupation	Council of Europe
Ecuador	country of citizenship	Organisation internationale de la Francophonie
Jean Le Rond d'Alembert	genre	Anton Chekhov
Yevgeny Yevtushenko	member of	Interscope Records
Trinidad and Tobago	member of	English
Philippines	member of	International Finance Corporation
Snoop Dogg	diplomatic relation	World Trade Organization
David Brewster	member of	International Telecommunication Union
Johann Wolfgang von Goethe	diplomatic relation	Zora Neale Hurston
Andy Williams	diplomatic relation	American Academy of Arts and Sciences
Samoa	record label	International Hydrographic Organization
Vladimir Nabokov	occupation	International Development Association
Mandy Moore	occupation	International Development Association
Peter Kropotkin	residence	Movement Coordination Centre Europe
Kiely Williams	record label	English
Jason Derulo	diplomatic relation	Interpol
Senegal	occupation	Group on Earth Observations
Slavoj Žižek	occupation	Universal Postal Union
Netherlands	occupation	People's Republic of China
Estonia	member of	Council of Europe
Ayumi Hamasaki	member of	Organisation of Islamic Cooperation
Kylie Minogue	member of	Accademia Nazionale delle Scienze detta dei XL
Wernher von Braun	member of	Asian Development Bank
Goldie Hawn	member of	English
Yoshiki	occupation	United Nations
Belgium	member of	Agency for the Prohibition of Nuclear Weapons in Latin America and the Caribbean
Jacques Brel	occupation	World Trade Organization
Morocco	instrument	International Telecommunication Union
Nat King Cole	member of	International Hydrographic Organization
Salman Rushdie	member of	International Energy Agency
Sergey Lazarev	spouse	Accademia Nazionale delle Scienze detta dei XL
Peter Kropotkin	diplomatic relation	English
Donny Hathaway	occupation	International Development Association
Roman Jakobson	occupation	Universal Postal Union
Aleksandr Solzhenitsyn	educated at	International Finance Corporation
Boris Grebenshchikov	languages spoken, written, or signed	Honoré de Balzac
Heinrich Schliemann	occupation	Berry Gordy
Mika	member of	United Kingdom of Great Britain and Ireland
Sergey Mikhalkov	genre	International Telecommunication Union
Drake	headquarters location	English
Golo Mann	occupation	International Hydrographic Organization
Macy Gray	member of	English
Julio Cortázar	member of	American Academy of Arts and Sciences
Friedrich Schiller	place of birth	Interpol
Karl Marx	occupation	American Academy of Arts and Sciences
Anna Karina	genre	English
John Cameron Mitchell	country of citizenship	Fyodor Dostoyevsky
J. Robert Oppenheimer	languages spoken, written, or signed	Movement Coordination Centre Europe
Pier Paolo Pasolini	member of	English
Richard Dawkins	diplomatic relation	World Trade Organization
Aleksandr Solzhenitsyn	genre	World Trade Organization
People's Republic of China	languages spoken, written, or signed	Universal Postal Union
Comoros	languages spoken, written, or signed	Universal Postal Union
Dietrich Fischer-Dieskau	languages spoken, written, or signed	myocardial infarction
Adolf Erik Nordenskiöld	occupation	Universal Postal Union
Mikhail Zadornov	ethnic group	myocardial infarction
Russell Brand	instrument	International Telecommunication Union
Richard Francis Burton	member of	American Academy of Arts and Sciences
People's Republic of China	member of	Lincean Academy
Gloria Estefan	influenced by	African Development Bank
Democratic Republic of the Congo	occupation	International Development Association
Laos	place of birth	United States of America
Robert Musil	occupation	Accademia Nazionale delle Scienze detta dei XL
Ingrid Michaelson	member of	Universal Postal Union
Iggy Pop	occupation	English
George Henschel	instrument	Group on Earth Observations
South Korea	languages spoken, written, or signed	English
Waylon Jennings	languages spoken, written, or signed	United States of America
Justin Timberlake	occupation	International Hydrographic Organization
Ava Gardner	member of	English
Uzeyir Hajibeyov	occupation	Arab Bank for Economic Development in Africa
Rainer Werner Fassbinder	country of citizenship	Universal Postal Union
Ivan Andreyevich Krylov	record label	Interpol
Bosnia and Herzegovina	sibling	Angola
Al Franken	member of	Interpol
William Faulkner	genre	Interpol
Whoopi Goldberg	time period	International Finance Corporation
Antigua and Barbuda	languages spoken, written, or signed	Asian Development Bank
Tomáš Garrigue Masaryk	member of	Universal Postal Union
Zoë Kravitz	genre	Movement Coordination Centre Europe
Iran	member of	Interpol
Heinrich Wilhelm Olbers	genre	Asian Development Bank
Damon Albarn	member of	International Development Association
Equatorial Guinea	diplomatic relation	Organisation of Islamic Cooperation
Shakira	occupation	International Bank for Reconstruction and Development
Bosnia and Herzegovina	member of	Nigeria
Italo Calvino	occupation	English
Ne-Yo	occupation	United Kingdom of Great Britain and Ireland
John William Strutt, 3rd Baron Rayleigh	occupation	Liechtenstein
Glen Campbell	languages spoken, written, or signed	English
Trey Parker	diplomatic relation	United Nations
Zambia	ethnic group	United Nations
Elfriede Jelinek	instrument	Group on Earth Observations
Panama	genre	Organization of American States
Kenya	occupation	Nuclear Suppliers Group
August Wilhelm Schlegel	diplomatic relation	People's Republic of China
Kyrgyzstan	member of	International Development Association
Heinrich Heine	occupation	International Finance Corporation
Malaysia	genre	Organization of American States
Heinrich Rudolf Hertz	instrument	Interpol
Jason Newsted	diplomatic relation	International Finance Corporation
People's Republic of China	occupation	Academy of Arts of the GDR
Zhores Alfyorov	genre	International Finance Corporation
Tatyana Tolstaya	occupation	International Finance Corporation
Taylor Swift	genre	International Telecommunication Union
Dima Bilan	occupation	English
Georges-Louis Leclerc, Comte de Buffon	country of citizenship	Ecuador
Burundi	languages spoken, written, or signed	English
Lesotho	occupation	Democratic Party
Henry James	occupation	People's Republic of China
Kurt Weill	occupation	English
Samoa	diplomatic relation	African Development Bank
Tom Wolfe	occupation	Group on Earth Observations
Fiona Apple	occupation	United Nations
Georgia	genre	International Bank for Reconstruction and Development
Vince Gill	instrument	Nuclear Suppliers Group
Tina Arena	religion	English
Rudyard Kipling	diplomatic relation	American Academy of Arts and Letters
Saint Kitts and Nevis	occupation	International Development Association
Equatorial Guinea	field of work	World Trade Organization
George Orwell	languages spoken, written, or signed	English
Ben Stiller	diplomatic relation	Universal Postal Union
John Farnham	member of	Visa Waiver Program
Claude Lévi-Strauss	record label	Missile Technology Control Regime
Shania Twain	place of death	International Finance Corporation
J. K. Rowling	instrument	United Nations
Johann Wolfgang von Goethe	occupation	Interpol
Drake	diplomatic relation	International Development Association
Penny Marshall	record label	International Telecommunication Union
August Schleicher	place of death	United Nations
Julio Iglesias	occupation	English
Bernard-Henri Lévy	occupation	Treaty on Open Skies
El Salvador	instrument	International Telecommunication Union
Benoit Mandelbrot	diplomatic relation	Treaty on Open Skies
Philippines	member of	World Trade Organization
Mark Wahlberg	country of citizenship	Organization of American States
Billie Holiday	country	World Trade Organization
Woody Guthrie	member of political party	United Nations
Brendon Urie	place of death	Movement Coordination Centre Europe
Count Basie	languages spoken, written, or signed	Nuclear Suppliers Group
Ľudovít Štúr	occupation	Holy See
Jason Mraz	member of	United Nations
Bulgaria	occupation	English
Alyson Michalka	occupation	American Academy of Arts and Letters
People's Republic of China	occupation	political scientist
Jimi Hendrix	diplomatic relation	American Academy of Arts and Sciences
Dorothy L. Sayers	member of political party	Organisation of Islamic Cooperation
Charles Babbage	ethnic group	English
Jacques Derrida	diplomatic relation	Interpol
Erich Kästner	genre	Accademia Nazionale delle Scienze detta dei XL
Ireland	occupation	Multilateral Investment Guarantee Agency
Emma Goldman	place of death	World Trade Organization
Djibouti	diplomatic relation	Commonwealth of Nations
Paul Valéry	diplomatic relation	Accademia Nazionale delle Scienze detta dei XL
Alyson Michalka	diplomatic relation	Organisation for Economic Cooperation and Development
United States of America	diplomatic relation	character actor
Sarah McLachlan	diplomatic relation	International Finance Corporation
Vladimir Putin	movement	Universal Postal Union
Azerbaijan	occupation	Janet Jackson
Lithuania	languages spoken, written, or signed	International Telecommunication Union
George Tabori	member of	English
Penny Marshall	languages spoken, written, or signed	International Development Association
Friedrich Nietzsche	occupation	International Finance Corporation
Felix Mendelssohn	employer	American Academy of Arts and Sciences
Victor Ambartsumian	continent	Council of Europe
Gambia	diplomatic relation	English
Estonia	genre	International Telecommunication Union
North Korea	diplomatic relation	Interpol
Jacques Derrida	ethnic group	International Finance Corporation
Ulrich von Wilamowitz-Moellendorff	diplomatic relation	People's Republic of China
The Edge	member of	English
Vitaly Ginzburg	genre	International Development Association
Pyotr Ilyich Tchaikovsky	diplomatic relation	United Arab Emirates
Carl Djerassi	record label	International Development Association
Ernst Curtius	sibling	Organization of American States
Theodor Nöldeke	genre	African Development Bank
Umberto Eco	country of citizenship	People's Republic of China
Tila Tequila	member of	Nuclear Suppliers Group
Alexander Rybak	instrument	Organisation for Economic Cooperation and Development
Alanis Morissette	instrument	Organisation internationale de la Francophonie
Ivan Yefremov	occupation	Organisation of Islamic Cooperation
San Marino	diplomatic relation	American Academy of Arts and Letters
Marlene Dietrich	educated at	American Academy of Arts and Letters
Jim Belushi	member of	International Development Association
Federated States of Micronesia	influenced by	Uganda
Mariah Carey	occupation	People's Republic of China
Franz Liszt	field of work	English
Bulgaria	occupation	African Union – United Nations Hybrid Operation in Darfur
Falco	occupation	People's Republic of China
Sidney Poitier	member of political party	English
Steve Martin	genre	English
Nicholas Marr	languages spoken, written, or signed	English
Indonesia	member of	Commonwealth of Nations
Boris Grebenshchikov	country of citizenship	Jordan
John Lennon	genre	Multilateral Investment Guarantee Agency
Judd Apatow	country of citizenship	UNESCO
Hong Kong	country	American Academy of Arts and Letters
Syria	occupation	International Telecommunication Union
Montenegro	diplomatic relation	International Hydrographic Organization
Mick Wingert	occupation	International Finance Corporation
Jean Le Rond d'Alembert	official language	Emmanuel Swedenborg
Dean Martin	occupation	English
Hungarian Academy of Sciences	record label	English
Ed Harris	country of citizenship	United States of America
Sweden	instrument	World Trade Organization
David Lindley	member of	Missile Technology Control Regime
Carly Simon	occupation	English
Gordon Lightfoot	diplomatic relation	World Trade Organization
Iceland	diplomatic relation	English
Estonia	member of	Asian Development Bank
Fyodor Dostoyevsky	occupation	Gabriel García Márquez
Whoopi Goldberg	instrument	Organisation for Economic Cooperation and Development
Angie Stone	ethnic group	Nuclear Suppliers Group
Spike Lee	place of burial	Alliance of Small Island States
Kelly Clarkson	occupation	American Academy of Arts and Sciences
Arnold Schwarzenegger	member of	Democratic Party
United States of America	diplomatic relation	International Finance Corporation
Mikhail Vassilyevich Lomonosov	member of	Netherlands
Emma Bunton	place of birth	Nuclear Suppliers Group
Lena Horne	occupation	English
Togo	record label	English
Romain Gary	educated at	Arab Fund for Economic and Social Development
Leonardo da Vinci	languages spoken, written, or signed	International Finance Corporation
W.E.B. Du Bois	instrument	Ashkenazi Jews
Sammy Davis Jr.	occupation	Universal Postal Union
David Lynch	diplomatic relation	Organization of American States
Albania	record label	English
Ludwig Wittgenstein	occupation	United States of America
Jaden Smith	diplomatic relation	Universal Postal Union
People's Republic of China	member of	Polydor Records
Johann Christoph Gottsched	diplomatic relation	International Development Association
Ulf Ekberg	occupation	American Academy of Arts and Letters
Venezuela	occupation	African Development Bank
Slavoj Žižek	member of	African Union
Madagascar	genre	American Academy of Arts and Sciences
Barbra Streisand	occupation	United States of America
Duke Ellington	member of	American Academy of Arts and Sciences
John Updike	cause of death	International Finance Corporation
Edmund Wilson	occupation	Alliance of Small Island States
Monica	instrument	Group on Earth Observations
United Arab Emirates	diplomatic relation	Visa Waiver Program
Jan Hammer	ethnic group	English
Ian McEwan	country of citizenship	American Academy of Arts and Letters
Steven Tyler	occupation	English
Goldie Hawn	occupation	Interpol
Uzbekistan	occupation	Organisation for Economic Cooperation and Development
Fred Astaire	diplomatic relation	International Finance Corporation
Fredric Jameson	member of	American Academy of Arts and Sciences
Antigua and Barbuda	diplomatic relation	American Academy of Arts and Letters
MC Hammer	continent	International Development Association
Mstislav Keldysh	instrument	Asian Development Bank
Ayumi Hamasaki	occupation	Organisation of Islamic Cooperation
Dmitry Glukhovsky	occupation	Ashkenazi Jews
Charles Wheatstone	country of citizenship	English
People's Republic of China	member of	Warner Music Group
Taiwan	member of	People's Republic of China
Jacques Brel	diplomatic relation	International Development Association
Peru	diplomatic relation	English
L. Frank Baum	occupation	Eurocontrol
Samuel P. Huntington	diplomatic relation	English
Ulrich von Wilamowitz-Moellendorff	occupation	Organisation of Islamic Cooperation
Peggy Lee	member of	English
Fred Hoyle	instrument	International Telecommunication Union
People's Republic of China	member of	renal insufficiency
Kingdom of the Netherlands	record label	United States of America
Herman Melville	record label	Taiwan
Edvard Radzinsky	occupation	American Academy of Arts and Letters
Henrik Steffens	educated at	English
Master P	employer	Visa Waiver Program
George Orwell	occupation	Universal Postal Union
Sky Ferreira	record label	Asian Development Bank
Simon Newcomb	record label	World Trade Organization
Kurt Cobain	country of citizenship	Interscope Records
Gavriil Troyepolsky	diplomatic relation	Alliance of Small Island States
Michelle Williams	occupation	Accademia Nazionale delle Scienze detta dei XL
Akon	occupation	Interpol
Kazakhstan	occupation	State of Palestine
Joseph Fourier	country of citizenship	International Telecommunication Union
Mark Wahlberg	place of birth	American Academy of Arts and Letters
Seychelles	cast member	English
United States of America	member of	South Africa
Ernst Curtius	occupation	United States of America
Fergie	instrument	African Development Bank
Vietnam	member of	International Development Association
Jerry Garcia	diplomatic relation	American Academy of Arts and Sciences
Kuwait	member of	International Development Association
Poland	sibling	International Hydrographic Organization
Thomas Aquinas	diplomatic relation	Taiwan
Taiwan	member of	International Telecommunication Union
Frédéric Joliot-Curie	member of	Cher
Viggo Mortensen	diplomatic relation	Interpol
Hilary Duff	member of	UNESCO
United States of America	occupation	Commonwealth of Nations
Mick Wingert	religion	Interpol
Whoopi Goldberg	occupation	Interpol
São Tomé and Príncipe	diplomatic relation	Libya
Brian Molko	member of	United Nations
Nepal	place of birth	Interpol
Arnold Schoenberg	occupation	American Academy of Arts and Letters
Zoolander	languages spoken, written, or signed	International Development Association
Fredric Jameson	place of birth	World Trade Organization
Prosper Mérimée	languages spoken, written, or signed	Organisation of Islamic Cooperation
Thomas Hobbes	country of citizenship	International Finance Corporation
Mircea Eliade	instrument	International Hydrographic Organization
Lauryn Hill	occupation	English
Khloé Kardashian	languages spoken, written, or signed	Commonwealth of Nations
Nigeria	member of	United States of America
Mohandas Karamchand Gandhi	employer	United Nations
Czech Republic	field of work	World Trade Organization
Franz Liszt	member of	International Development Association
David Foster	diplomatic relation	World Trade Organization
Theodore Roosevelt	occupation	English
Georgia	occupation	International Bank for Reconstruction and Development
David Mitchell	occupation	American Academy of Arts and Sciences
Bangladesh	member of	International Hydrographic Organization
Duke Ellington	occupation	United Kingdom of Great Britain and Ireland
Joyce Carol Oates	influenced by	Accademia Nazionale delle Scienze detta dei XL
Nahum Sokolow	occupation	Visa Waiver Program
Valeriya Novodvorskaya	member of	International Development Association
Lori Lieberman	member of	United Nations
Ray Charles	member of	Nuclear Suppliers Group
Mylène Farmer	genre	International Finance Corporation
United Kingdom	country of citizenship	International Bank for Reconstruction and Development
Theodore Roosevelt	genre	Universal Postal Union
Liza Minnelli	diplomatic relation	American Academy of Arts and Sciences
Mauritania	member of	UNESCO
Osip Mandelstam	country of citizenship	English
Sudan	unmarried partner	Universal Postal Union
Steve Allen	occupation	Interpol
Nicaragua	country of citizenship	Universal Postal Union
Stefan Zweig	genre	English
Frank Wedekind	record label	Universal Postal Union
Antigua and Barbuda	occupation	Georg Wilhelm Friedrich Hegel
United States of America	diplomatic relation	Pakistan
Seth Rogen	occupation	United States of America
Juilliard School	diplomatic relation	Republic of Cyprus
Henri Poincaré	diplomatic relation	Organisation internationale de la Francophonie
People's Republic of China	occupation	Decca
Ulrich von Wilamowitz-Moellendorff	occupation	Göttingen Academy of Sciences
Dennis Gabor	occupation	Interpol
Adam Ant	continent	International Hydrographic Organization
Cyndi Lauper	diplomatic relation	English
Gambia	occupation	United Nations
Tinashe	country of citizenship	African Development Bank
Jean Le Rond d'Alembert	continent	D. H. Lawrence
Barry Gibb	genre	United Kingdom of Great Britain and Ireland
Fiji	genre	Universal Postal Union
Sacha Baron Cohen	member of	Visa Waiver Program
John Legend	diplomatic relation	United Nations
Bertrand Russell	influenced by	International Finance Corporation
Gotthelf Fischer von Waldheim	diplomatic relation	Universal Postal Union
Woody Allen	occupation	United Nations
Malaysia	occupation	Hannah Arendt
Antigua and Barbuda	instrument	Dominica
Etta James	genre	International Telecommunication Union
Suzi Quatro	occupation	Interpol
David Lynch	cause of death	United Nations
Tunisia	influenced by	Saudi Arabia
Jean-Baptiste Dumas	occupation	English
John Lennon	occupation	International Centre for Settlement of Investment Disputes
United States of America	diplomatic relation	American Philosophical Society
Vanessa Williams	diplomatic relation	World Trade Organization
Eminem	country of citizenship	English
Paraguay	place of birth	Visa Waiver Program
Cambodia	influenced by	Schengen Area
Lucio Dalla	sibling	Organisation for Economic Cooperation and Development
Jordin Sparks	occupation	English
Friedrich Nietzsche	diplomatic relation	English
Meat Loaf	diplomatic relation	Organisation of Islamic Cooperation
Solomon Islands	occupation	Visa Waiver Program
Mick Jagger	influenced by	International Telecommunication Union
Latvia	genre	International Finance Corporation
People's Republic of China	member of	German Academy of Sciences at Berlin
Ghana	occupation	English
Eric Idle	diplomatic relation	United Nations
Sofia Kovalevskaya	diplomatic relation	United Nations
Bosnia and Herzegovina	occupation	English
Count Basie	occupation	International Finance Corporation
Ethiopia	diplomatic relation	English
Ferdinand von Richthofen	member of	United States of America
Édouard René de Laboulaye	diplomatic relation	myocardial infarction
United States of America	occupation	Malta
Bosnia and Herzegovina	country of citizenship	myocardial infarction
Gilles Deleuze	member of	International Finance Corporation
Mikhail Vassilyevich Lomonosov	occupation	A&M Records
Frank Zappa	place of death	English
Anton Chekhov	diplomatic relation	United Nations
Miguel de Unamuno	genre	English
Yevgeny Zamyatin	occupation	English
Lisa Lopes	member of	International Development Association
Friedrich Nietzsche	occupation	Organisation for Economic Cooperation and Development
Robert McNamara	occupation	English
Federated States of Micronesia	diplomatic relation	Democratic Party
United States of America	occupation	Netherlands
Heinrich Rudolf Hertz	member of	African Union
Randy Travis	continent	Movement Coordination Centre Europe
Bob Seger	country of citizenship	International Development Association
George Frideric Handel	languages spoken, written, or signed	English
David Attenborough	occupation	English
Charles Baudelaire	diplomatic relation	English
Eugen Rosenstock-Huessy	religion	International Finance Corporation
Gabon	member of	American Academy of Arts and Sciences
Vanessa Carlton	member of	American Academy of Arts and Letters
Zimbabwe	occupation	English
South Korea	official language	English
Aleksandr Solzhenitsyn	occupation	United Kingdom of Great Britain and Ireland
Uruguay	diplomatic relation	International Development Association
Thailand	occupation	International Hydrographic Organization
United States of America	occupation	English
Portugal	occupation	Universal Postal Union
Greece	ethnic group	World Trade Organization
John Frederick William Herschel	member of	International Development Association
Bhimrao Ramji Ambedkar	genre	International Finance Corporation
Leonard Cohen	genre	American Academy of Arts and Letters
Aram Khachaturian	diplomatic relation	English
Henry James	place of birth	Interpol
Alexander Rybak	instrument	English
Carl Friedrich von Weizsäcker	diplomatic relation	Organisation of Islamic Cooperation
Ingeborg Bachmann	member of	Universal Postal Union
Mýa	ethnic group	Arab Bank for Economic Development in Africa
Dima Bilan	member of	World Trade Organization
J. J. Abrams	diplomatic relation	Interpol
Philip Roth	occupation	Accademia Nazionale delle Scienze detta dei XL
Miguel	occupation	American Academy of Arts and Sciences
Poland	ethnic group	United States of America
Ciara	occupation	United States of America
Bahamas	occupation	Commonwealth of Nations
Euclides da Cunha	occupation	South Sudan
São Tomé and Príncipe	occupation	Albert Camus
Bing Crosby	diplomatic relation	Alliance of Small Island States
Togo	field of work	International Finance Corporation
Denis Johnson	diplomatic relation	United Nations
Nena	country of citizenship	World Trade Organization
Sergey Lazarev	diplomatic relation	English
will.i.am	occupation	Alliance of Small Island States
Japan	occupation	African Union – United Nations Hybrid Operation in Darfur
Greece	instrument	International Finance Corporation
Robin Thicke	ethnic group	American Academy of Arts and Sciences
Estonia	occupation	Group on Earth Observations
Bangladesh	occupation	United Nations
United States of America	diplomatic relation	Mozambique
Aaliyah	member of	Group on Earth Observations
Bangladesh	member of	Moldova
Fiji	occupation	English
Amiri Baraka	member of	Asian Development Bank
Brad Pitt	member of	American Academy of Arts and Letters
Nigeria	influenced by	Universal Postal Union
Taiwan	occupation	Samuel Johnson
India	occupation	International Bank for Reconstruction and Development
United States of America	occupation	Friedrich Engels
Yo-Yo Ma	diplomatic relation	English
Adam Levine	diplomatic relation	Interpol
Tom Hanks	diplomatic relation	United Nations
Antigua and Barbuda	diplomatic relation	American Academy of Arts and Sciences
Heinrich Schliemann	place of burial	Caribbean Development Bank
Heinrich Rudolf Hertz	instrument	Universal Postal Union
MC Hammer	languages spoken, written, or signed	English
Mikhail Vassilyevich Lomonosov	continent	University of Paris (1896-1968)
Siméon Denis Poisson	occupation	English
Justin Timberlake	occupation	Organisation internationale de la Francophonie
Edward Sabine	diplomatic relation	African Development Bank
Leszek Kołakowski	occupation	Universal Postal Union
Simon Sechter	occupation	myocardial infarction
Al Jolson	member of	International Development Association
Kris Kristofferson	member of	United States of America
Elmer Bernstein	country of citizenship	United States of America
Vladimir Putin	occupation	English
Hungary	member of	International Hydrographic Organization
Paul Langevin	occupation	Universal Postal Union
Cuba	occupation	World Trade Organization
Bill Cosby	member of	Nuclear Suppliers Group
Eugène Ionesco	member of	United Nations
Steve Carell	place of burial	Democratic Party
Ivan Illich	educated at	Søren Kierkegaard
William Shatner	record label	English
Gottfried Wilhelm Leibniz	occupation	State of Palestine
Maya Angelou	occupation	Accademia Nazionale delle Scienze detta dei XL
Clint Eastwood	occupation	English
Tupac Shakur	occupation	Asia-Pacific Economic Cooperation
Édouard René de Laboulaye	member of	United Nations
Dominica	occupation	United States of America
Bosnia and Herzegovina	member of	Taiwan
James Clerk Maxwell	occupation	Group on Earth Observations
k.d. lang	diplomatic relation	United Kingdom of Great Britain and Ireland
Vietnam	occupation	Alliance of Small Island States
Salman Rushdie	occupation	Universal Postal Union
Igor Stravinsky	languages spoken, written, or signed	Interpol
Peter Debye	diplomatic relation	International Development Association
Maureen Tucker	diplomatic relation	Universal Postal Union
Herman Francis Mark	member of	Schengen Area
Eldar Ryazanov	member of	United Nations
Guyana	languages spoken, written, or signed	Accademia Nazionale delle Scienze detta dei XL
Dominican Republic	country of citizenship	English
Greece	member of political party	Interpol
Van McCoy	occupation	American Academy of Arts and Letters
Pat Boone	instrument	English
Simone de Beauvoir	occupation	Asian Development Bank
Jim Messina	diplomatic relation	United States of America
Luxembourg	languages spoken, written, or signed	English
Sun Ra	occupation	African Development Bank
Sheldon Lee Glashow	member of	Commonwealth of Nations
Isaac Bashevis Singer	member of	English
Paraguay	genre	English
Malaysia	diplomatic relation	Mel Brooks
John Stuart Mill	occupation	African Development Bank
Hannes Alfvén	member of	United States of America
United States of America	record label	International Energy Agency
Iran	diplomatic relation	English
Theodor Mommsen	genre	United States of America
John William Strutt, 3rd Baron Rayleigh	occupation	Interpol
Armenia	occupation	Enrique Iglesias
Pedro II of Brazil	occupation	English
Alice Walker	genre	Visa Waiver Program
Angelina Jolie	member of	Asian Development Bank
Seth Rogen	occupation	American Academy of Arts and Sciences
Michael Nesmith	occupation	Australia Group
Clive Barker	occupation	United Nations
Alla Pugacheva	diplomatic relation	Universal Postal Union
East Timor	genre	English
Jemaine Clement	diplomatic relation	English
Noël Coward	instrument	English
Azerbaijan	diplomatic relation	English
Ralph Vaughan Williams	diplomatic relation	Interpol
Switzerland	genre	Multilateral Investment Guarantee Agency
Indonesia	part of	Accademia Nazionale delle Scienze detta dei XL
Paul Langevin	country of citizenship	English
United States of America	occupation	Arista
Phil Harris	member of	International Finance Corporation
Eswatini	country of citizenship	Federated States of Micronesia
Konstantin Simonov	diplomatic relation	Missile Technology Control Regime
Saudi Arabia	occupation	International Finance Corporation
Ariana Grande	diplomatic relation	Universal Postal Union
Charles Dickens	member of	Democratic Party
Heinrich Heine	occupation	World Trade Organization
William S. Burroughs	cause of death	Bosnia and Herzegovina
Jean-Baptiste Dumas	diplomatic relation	American Academy of Arts and Letters
Claude Lévi-Strauss	diplomatic relation	English
Sebastian Haffner	member of	Republican Party
Cape Verde	genre	United Nations
Lonnie Liston Smith	occupation	United Nations
"Weird Al" Yankovic	occupation	20th century
United Arab Emirates	member of	Universal Postal Union
People's Republic of China	occupation	Switzerland
Theo van Gogh	occupation	American Academy of Arts and Sciences
Christoph Wilhelm Hufeland	member of	International Finance Corporation
Charlton Heston	official language	World Trade Organization
George Harrison	country of citizenship	English
Adam Levine	religion	International Telecommunication Union
Niger	member of	English
Marilyn Manson	occupation	International Development Association
United Kingdom	genre	Group on Earth Observations
People's Republic of China	diplomatic relation	North Korea
Jessica Simpson	instrument	English
François-René de Chateaubriand	member of	University of Vienna
Malaysia	influenced by	Council of Europe
Kyrgyzstan	residence	Latin America
Hayley Williams	diplomatic relation	American Academy of Arts and Sciences
Don DeLillo	cause of death	Visa Waiver Program
Thomas Young	occupation	English
Slovenia	languages spoken, written, or signed	Council of Europe
Ivan Yefremov	diplomatic relation	Universal Postal Union
John von Neumann	genre	Treaty on Open Skies
Ukraine	sibling	United States of America
Venezuela	member of	São Tomé and Príncipe
RuPaul	sibling	Taiwan
Franz Kafka	religion	English
Jean-Paul Sartre	occupation	United Kingdom of Great Britain and Ireland
Kingsley Amis	diplomatic relation	Missile Technology Control Regime
Lucio Dalla	occupation	American Academy of Arts and Letters
Island Records	languages spoken, written, or signed	English
John Cleese	occupation	African Development Bank
Gore Vidal	diplomatic relation	Alliance of Small Island States
Igor Stravinsky	languages spoken, written, or signed	Organisation of Islamic Cooperation
Adolf Erik Nordenskiöld	occupation	United Nations
People's Republic of China	member of	Russian Academy of Sciences
Fredric Jameson	influenced by	American Academy of Arts and Sciences
Ayn Rand	country of citizenship	International Finance Corporation
United States of America	instrument	University of Göttingen
Ursula K. Le Guin	employer	Interscope Records
Severo Ochoa	occupation	Bosnia and Herzegovina
Cuba	occupation	World Trade Organization
Susan Sontag	diplomatic relation	United Nations
Mýa	member of	Organisation of Islamic Cooperation
Wilhelm von Humboldt	member of	Royal Society of Literature
Denmark	occupation	Organisation internationale de la Francophonie
Poland	occupation	International Finance Corporation
Frank Zappa	country of citizenship	English
François-René de Chateaubriand	occupation	German Academy of Sciences at Berlin
Jules Verne	place of birth	Interpol
Iceland	occupation	Interpol
Mike Shinoda	religion	African Development Bank
Andrea Bocelli	member of political party	Universal Postal Union
Herman Melville	instrument	English
Adolf Erik Nordenskiöld	occupation	International Development Association
W.E.B. Du Bois	occupation	New Zealand
Justin Timberlake	member of	English
Lena Meyer-Landrut	diplomatic relation	Accademia Nazionale delle Scienze detta dei XL
Antigua and Barbuda	diplomatic relation	Evelyn Waugh
Aimee Mann	diplomatic relation	Universal Postal Union
Bret Easton Ellis	diplomatic relation	Fyodor Dostoyevsky
Émile Zola	ethnic group	English
Mariah Carey	member of	Interpol
Leo Tolstoy	country of citizenship	English
Richard Harris	occupation	International Finance Corporation
Whoopi Goldberg	occupation	American Academy of Arts and Letters
Kingdom of Prussia	place of death	English
Gambia	member of	African Development Bank
Tyrese Gibson	occupation	English
Kosovo	country of citizenship	David Hume
Nelly	influenced by	Universal Postal Union
Carole King	occupation	English
Haiti	occupation	People's Republic of China
Carlos Fuentes	occupation	Alliance of Small Island States
Saint Kitts and Nevis	diplomatic relation	American Academy of Arts and Letters
Gloria Estefan	occupation	International Development Association
Milla Jovovich	diplomatic relation	Universal Postal Union
Søren Kierkegaard	place of birth	United States of America
W.E.B. Du Bois	member of political party	science fiction
John Paul II	languages spoken, written, or signed	United Nations
Enzo Jannacci	occupation	International Telecommunication Union
Master P	instrument	Interpol
Tom Wolfe	member of	African Development Bank
Serbia	member of	Interpol
Frank Zappa	occupation	International Telecommunication Union
Xavier Cugat	diplomatic relation	English
Rita Levi-Montalcini	languages spoken, written, or signed	AFRISTAT
Malta	member of	United States of America
Mick Ronson	record label	Missile Technology Control Regime
Elie Wiesel	member of	International Finance Corporation
Madagascar	diplomatic relation	World Trade Organization
Natalie Portman	diplomatic relation	United Nations
Ludvig Holberg	genre	Interpol
Liv Ullmann	member of political party	Schengen Area
Peter Ustinov	diplomatic relation	Organization of American States
Carl Djerassi	diplomatic relation	Universal Postal Union
Paul Anka	occupation	English
Fiji	diplomatic relation	Missile Technology Control Regime
Daniel Handler	sibling	Accademia Nazionale delle Scienze detta dei XL
Lil Mama	genre	International Finance Corporation
Gambia	country of citizenship	World Trade Organization
Jean-Baptiste Biot	diplomatic relation	Interpol
People's Republic of China	occupation	United States of America
People's Republic of China	member of	Princeton University
Joseph Priestley	occupation	Interpol
Vitas	occupation	International Finance Corporation
Joss Whedon	country of citizenship	English
Michael Nesmith	occupation	International Finance Corporation
Salvador de Madariaga	member of	John Milton
Peter Handke	occupation	English
Ilya Ilf	occupation	United Kingdom of Great Britain and Ireland
Bangladesh	member of political party	Samoa
Isaac Hayes	place of birth	International Telecommunication Union
Per Olov Enquist	occupation	Universal Postal Union
Friedrich Schiller	sibling	English
André 3000	occupation	Asian Development Bank
